广东东鹏文化创意股份有限公司	文化创意策划及推广服务、企业经营管理咨询、物业租赁、实业投资。〓（依法须经批准的项目,经相关部门批准后方可开展经营活动）
广东高菲格儿医药生物科技有限公司	生物医药研究、制造,健康管理咨询,健康技术推广、技术开发、技术转让、技术咨询及技术服务,文化艺术活动组织交流,广告设计、制作、代理及发布,展览展示服务,电脑动画设计,影视策划,会议服务,礼仪服务,企业策划,企业管理咨询,工艺美术设计,摄影服务,持有效审批证件从事影视制作,美容服务;销售及网上销售:中药,中成药,保健品,保健食品,保健用品,化妆品,护肤品,美容用品,农产品,医疗器械,按摩器材,健身器材,电子产品,服装,鞋帽,日用品,玩具,计算机软件及辅助设备,饮料;货物或技术进出口（国家禁止或涉及行政审批的货物和技术进出口除外）;食品经营,中医学与中药学研究服务,养生保健服务,企业总部管理服务。（依法须批准的项目,经相关部门批准后方可开展经营活动。）（依法须经批准的项目,经相关部门批准后方可开展经营活动）
华瀚（佛山）影视传媒有限公司	电视剧、动画片（制作须另申报）,专题、专栏（不含时政新闻类）,综艺制作、发行（凭《广播电视节目制作经营许可证》经营）;电影制作、发行;多媒体设计,影视技术开发、咨询、转让;影视服装、道具、器材租赁,汽车租赁（不含驾驶劳务服务）;影视文化信息咨询,影视剧本创作、策划、销售;摄影摄像服务,演员经纪服务;影视策划,文化交流活动策划,影视文化项目开发,会务会展服务,广告制作、代理、发布;会议服务;承办展览展示;企业项目策划;公共关系服务;计算机技术推广服务;经济贸易咨询（不含投资咨询）;摄影扩印服务;图文设计、制作;婚姻介绍服务;家政服务;市场调查;计算机系统服务;翻译服务;商务信息咨询;企业形象策划服务;其他未列明商务服务;计算机软硬件技术开发、转让、咨询服务。（依法须经批准的项目,经相关部门批准后方可开展经营活动）
广东永烨实业有限公司	一般项目:针纺织品及原料销售;针纺织品销售;金属材料销售;五金产品批发;五金产品零售;化工产品销售（不含许可类化工产品）;有色金属合金销售;金属矿石销售;机械设备销售;煤炭及制品销售;石油制品销售（不含危险化学品）;建筑材料销售;电子元器件与机电组件设备销售;机械电气设备销售;办公设备销售;皮革制品销售;玩具销售;化肥销售;食用农产品零售;光伏设备及元器件销售;太阳能热利用装备销售;农副产品销售;食用农产品批发;饲料原料销售;棉、麻销售;初级农产品收购;棉花收购;粮食收购;工程和技术研究和试验发展;技术服务、技术开发、技术咨询、技术交流、技术转让、技术推广;农业科学研究和试验发展;规划设计管理;园林绿化工程施工;花卉种植;粮油仓储服务;普通货物仓储服务（不含危险化学品等需许可审批的项目）;装卸搬运;非居住房地产租赁;技术进出口;货物进出口。（除依法须经批准的项目外,凭营业执照依法自主开展经营活动）许可项目:道路货物运输（不含危险货物）。（依法须经批准的项目,经相关部门批准后方可开展经营活动,具体经营项目以相关部门批准文件或许可证件为准）
佛山市洛神旅游文化发展有限公司	一般项目:旅游开发项目策划咨询;经营民宿;露营地服务;组织体育表演活动;以自有资金从事投资活动;物业管理;酒店管理;园林绿化工程施工;汽车租赁;摄影扩印服务;互联网销售（除销售需要许可的商品）;房地产咨询;广告设计、代理;广告制作;体验式拓展活动及策划;企业管理咨询;企业形象策划;会议及展览服务;非居住房地产租赁;普通露天游乐场所游乐设备销售;房地产经纪。（除依法须经批准的项目外,凭营业执照依法自主开展经营活动）许可项目:住宅室内装饰装修。（依法须经批准的项目,经相关部门批准后方可开展经营活动,具体经营项目以相关部门批准文件或许可证件为准）
金狮文化传播（佛山）有限公司	影视节目制作;其他文化艺术业;专业设计服务;软件开发;互联网信息服务;信息技术咨询服务;综合零售;互联网批发、互联网零售（法律、行政法规或者国务院决定禁止和规定在登记前须经批准的项目除外）;货物进出口（国家禁止或涉及行政审批的货物进出口除外）。（依法须经批准的项目,经相关部门批准后方可开展经营活动。）（依法须经批准的项目,经相关部门批准后方可开展经营活动）
佛山珠江传媒日报有限公司	一般项目:广告制作;广告设计、代理;组织文化艺术交流活动;组织体育表演活动;会议及展览服务;技术服务、技术开发、技术咨询、技术交流、技术转让、技术推广;信息咨询服务（不含许可类信息咨询服务）;市场营销策划;票务代理服务;房地产经纪;人力资源服务（不含职业中介活动、劳务派遣服务）;业务培训（不含教育培训、职业技能培训等需取得许可的培训）;旅行社服务网点旅游招徕、咨询服务;互联网销售（除销售需要许可的商品）;日用百货销售;办公用品销售;家用电器销售;通信设备销售;塑料制品销售;建筑材料销售;门窗销售;卫生陶瓷制品销售;卫生洁具销售;照明器具销售;汽车装饰用品销售;汽车零配件零售;体育用品及器材零售;工艺美术品及礼仪用品销售（象牙及其制品除外）;玩具销售;化妆品零售;美发饰品销售;卫生用品和一次性使用医疗用品销售;广告发布;摄像及视频制作服务;电影摄制服务。（除依法须经批准的项目外,凭营业执照依法自主开展经营活动）许可项目:出版物零售;出版物印刷;印刷品装订服务;职业中介活动;食品销售;食品互联网销售;旅游业务;互联网新闻信息服务;信息网络传播视听节目;音像制品制作。（依法须经批准的项目,经相关部门批准后方可开展经营活动,具体经营项目以相关部门批准文件或许可证件为准）
佛山市佛视文化传播有限公司	一般项目：组织文化艺术交流活动；组织体育表演活动；项目策划与公关服务；文化娱乐经纪人服务；其他文化艺术经纪代理；服装服饰出租；租赁服务（不含许可类租赁服务）；个人商务服务；票务代理服务；广告制作；广告发布；广告设计、代理；贸易经纪；互联网销售（除销售需要许可的商品）；销售代理；国内贸易代理；知识产权服务（专利代理服务除外）；业务培训（不含教育培训、职业技能培训等需取得许可的培训）；教育咨询服务（不含涉许可审批的教育培训活动）；食品互联网销售（仅销售预包装食品）。（除依法须经批准的项目外，凭营业执照依法自主开展经营活动）许可项目：营业性演出；演出经纪；酒类经营；食品销售。（依法须经批准的项目，经相关部门批准后方可开展经营活动，具体经营项目以相关部门批准文件或许可证件为准）
佛山云鼎天姬影视传媒有限公司	影视节目制作,电影和广播电视节目发行，演出经纪代理服务，文化艺术活动组织策划，文化娱乐经纪人，互联网技术推广服务，会议及展览服务，广告设计、制作、代理、发布，市场调查，企业管理策划服务。（依法须经批准的项目，经相关部门批准后方可开展经营活动。）（依法须经批准的项目，经相关部门批准后方可开展经营活动）
杜松影视（佛山）有限公司	许可项目:电视剧制作;电视剧发行;电影发行;广播电视节目制作经营;音像制品制作;营业性演出。（依法须经批准的项目,经相关部门批准后方可开展经营活动,具体经营项目以相关部门批准文件或许可证件为准）一般项目:电影摄制服务;电影制片;文化用品设备出租;信息咨询服务（不含许可类信息咨询服务）;文艺创作;版权代理;知识产权服务（专利代理服务除外）;摄像及视频制作服务;文化娱乐经纪人服务;数字内容制作服务（不含出版发行）;组织文化艺术交流活动;广告制作;广告设计、代理;广告发布;专业设计服务;会议及展览服务;咨询策划服务;技术服务、技术开发、技术咨询、技术交流、技术转让、技术推广。（除依法须经批准的项目外,凭营业执照依法自主开展经营活动）
佛山市民间艺术研究社有限公司	民间传统工艺传承与推广,彩灯、剪纸、秋色、木版年画、狮头设计、制作、展出,文化活动组织策划;经营本企业自产产品的出口业务和本企业所需的原辅材料、仪器仪表、机械设备、零配件及相关技术的进口业务（国家限定公司经营或禁止进出口的商品及技术除外）;工艺美术设计服务,文化艺术展览服务,工艺美术工程安装服务,旅游文化推广服务;民间艺术培训;工艺美术咨询服务;民间工艺品收购（不含金银及制品和文物）;销售:工艺美术品（零售金、银首饰）,日用百货,陶瓷制品,家用电器;零售:副食品,非酒精饮料,茶叶;物业租赁。（依法须经批准的项目,经相关部门批准后方可开展经营活动。）（依法须经批准的项目,经相关部门批准后方可开展经营活动）
佛山陶城传媒有限公司	持有效审批证件从事电影制作（影视制作）;计算机软、硬件开发、咨询服务,广告设计、制作、发布、代理服务,文化艺术交流活动策划、企业形象策划、市场营销策划,图文设计制作、三维技术制作,会务服务、展览展示服务、摄影服务,陶瓷工业品的设计、艺术创作,办公家具销售,货物进出口和技术进出口。（依法须经批准的项目,经相关部门批准后方可开展经营活动。）（依法须经批准的项目,经相关部门批准后方可开展经营活动）
佛山市星聚传媒有限公司	一般项目;电影摄制服务;其他文化艺术经纪代理;文艺创作;文化娱乐经纪人服务;体育经纪人服务;社会经济咨询服务;摄像及视频制作服务;包装服务;会议及展览服务;礼仪服务;专业设计服务;咨询策划服务;信息咨询服务（不含许可类信息咨询服务）;教育咨询服务（不含涉许可审批的教育培训活动）;企业形象策划;市场营销策划;企业管理咨询;数字内容制作服务（不含出版发行）;数据处理和存储支持服务;从事语言能力、艺术、体育、科技等培训的营利性民办培训服务机构（除面向中小学生开展的学科类、语言类文化教育培训）;组织文化艺术交流活动;广告设计、代理;广告发布（非广播电台、电视台、报刊出版单位）;技术服务、技术开发、技术咨询、技术交流、技术转让、技术推广;软件开发;国内贸易代理;互联网销售（除销售需要许可的商品）。（除依法须经批准的项目外,凭营业执照依法自主开展经营活动）许可项目:营业性演出;演出经纪;艺术考级活动;音像制品制作;互联网直播服务（不含新闻信息服务、网络表演、网络视听节目）。（依法须经批准的项目,经相关部门批准后方可开展经营活动,具体经营项目以相关部门批准文件或许可证件为准）
佛山市卓越里程文化传播有限公司	一般项目:文艺创作;企业管理咨询;会议及展览服务;企业形象策划;财务咨询;市场调查（不含涉外调查）;中小学生校外托管服务;安全咨询服务;体验式拓展活动及策划;体育赛事策划;招生辅助服务;教育教学检测和评价活动;组织文化艺术交流活动;体育健康服务;棋牌室服务;业务培训（不含教育培训、职业技能培训等需取得许可的培训）;健康咨询服务（不含诊疗服务）;信息技术咨询服务;面向家长实施的家庭教育咨询服务;信息系统集成服务。（除依法须经批准的项目外,凭营业执照依法自主开展经营活动）
佛山市角落文化传播有限公司	文化传播策划、交流；文化活动策划，品牌策划，营销策划，企业形象策划，文化交流活动策划，演出性活动策划，影视策划；庆典活动策划，户外拓展活动策划；企业管理；商品信息咨询；展览展示服务；广告策划、设计、制作、代理、发布；动漫设计服务；摄影服务；广告器材、摄影器材、影视器材、影视服装设计及租赁；食品经营；餐饮服务；销售：工艺品、咖啡器皿。（依法须经批准的项目，经相关部门批准后方可开展经营活动。）〓（依法须经批准的项目，经相关部门批准后方可开展经营活动）
佛山市瑞塔健身有限公司	健身服务。（依法须经批准的项目,经相关部门批准后方可开展经营活动。）（依法须经批准的项目,经相关部门批准后方可开展经营活动）
广东第六感文化传播有限公司	组织文化艺术交流活动；设计、制作、代理、发布广告；会议展览服务；市场营销策划；计算机系统服务；计算机软硬件技术开发及推广；企业管理咨询；财务咨询；市场调查。（依法须经批准的项目，经相关部门批准后方可开展经营活动）
广东中资盛世影视传媒有限公司	电影和影视节目制作,影视策划;动漫设计;设计、制作、代理、发布广告;营利性演出,演出经纪代理服务。（依法须经批准的项目,经相关部门批准后方可开展经营活动）
广东十一企业管理有限公司	一般项目:企业管理;社会经济咨询服务;物业管理;工程管理服务;计算机及通讯设备租赁;汽车租赁;非居住房地产租货;土地使用权租赁;住房租赁;办公设备租赁服务;运输设备租赁服务;专业设计服务;文化娱乐经纪人服务;会议及展览服务;广告制作;广告发布（非广播电台、电视台、报刊出版单位）;广告设计、代理;企业形象策划;房地产咨询;房地产评估;房地产经纪;电子产品销售;汽车零配件零售;汽车零配件批发;汽车装饰用品销售;汽车新车销售;汽车旧车销售;新能源汽车整车销售;新能源汽车换电设施销售;国内贸易代理;人力资源服务（不含职业中介活动、劳务派造服务）;劳务服务（不含劳务派遣）。许可项目:房地产开发经营。（依法须经批准的项目,经相关部门批准后方可开展经营活动）
牧梵创意影视传媒（佛山）有限公司	广播电视节目制作经营、电影制作、发行；多媒体设计，影视技术开发、咨询、转让；影视服装、道具、器材、汽车（不含客货运运营）租赁；影视文化信息咨询；影视剧本创作、策划、销售；摄影摄像服务；企业品牌策划服务；版权登记代理、演员经纪代理；影视策划、文化交流活动策划；影视文化项目开发；会务会展服务；广告设计、制作、发布、代理。（依法须经批准的项目，经相关部门批准后方可开展经营活动）
佛山市能顺景家具有限公司	销售及网上销售:家具、家居用品、纺织品、针织品及原料（不含危险化学品）、服装、鞋帽、箱包、化妆品、卫生洁具、清洁用品、厨房用具、日用品、灯具、小饰物、汽车零配件、工艺品（不含象牙及其制品）、收藏品（不含文物）、家用电器、宠物用品、玩具、乐器;国内贸易;服务:计算机软件开发、计算机信息技术咨询、网络技术推广服务,网络信息技术咨询,市场营销策划及推广,广告设计、制作、代理、发布,互联网公共服务平台;房地产租赁经营;互联网信息服务;商务信息咨询、企业管理咨询。（依法须经批准的项目,经相关部门批准后方可开展经营活动。）（依法须经批准的项目,经相关部门批准后方可开展经营活动）
佛山中奥广场管理有限公司	承办体育比赛,文化演出和会议展览服务,体育活动的组织策划,体育信息咨询,体育训练指导,体育健身,体育场所出租与管理;广告发布;停车场管理;体育用品销售;持有效审批证件从事食品流通。（依法须经批准的项目,经相关部门批准后方可开展经营活动。）（依法须经批准的项目,经相关部门批准后方可开展经营活动）
广东一品堂品牌营销策划有限公司	服务:企业市场营销策划,企业形象策划,企业管理咨询,企业品牌推广,广告设计、策划、制作、代理及发布,商标代理,企业文化活动策划,企业文化艺术交流策划,会议及展览服务,礼仪服务,摄影服务,舞台搭建,舞台音响设备安装、调试及出租,室内及室外装饰设计,建筑装饰工程施工,工业品外观设计,电脑图文制作,美术设计,计算机软件开发,互联网信息服务（不含网吧,不含新闻、出版、教育、医疗保健、药品、医疗器械、电子公告）,计算机科学技术研究,信息系统集成及维护;网上销售:装饰材料、建筑材料、文具用品、工艺品、日用品、五金产品、办公用品、电子产品;国内贸易;持有效审批证件承装、承修、承试供电设施和受电设施;数字化工业商业模式设计、数字化工业品牌体系设计、数字化工业营销战略规划设计、三维（3D）打印技术推广服务。（依法须经批准的项目,经相关部门批准后方可开展经营活动。）（依法须经批准的项目,经相关部门批准后方可开展经营活动）
佛山市思考乐文化有限公司	一般项目:组织文化艺术交流活动;组织体育表演活动;软件开发;非居住房地产租赁;以自有资金从事投资活动;幼儿园外托管服务;中小学生校外托管服务;教育教学检测和评价活动;健身休闲活动;体育健康服务;招生辅助服务;体验式拓展活动及策划;体育赛事策划;体育用品设备出租;体育保障组织;文艺创作;数字内容制作服务（不含出版发行）;业务培训（不含教育培训、职业技能培训等需取得许可的培训）;图书管理服务;家政服务;面向家长实施的家庭教育咨询服务;体育竞赛组织。（除依法须经批准的项目外,凭营业执照依法自主开展经营活动）
广东雪莱健身有限公司	一般项目:健身休闲活动;体育保障组织;体育用品及器材零售;软件开发;信息咨询服务（不含许可类信息咨询服务）;体育用品及器材批发;体育健康服务;摄像及视频制作服务;食品销售（仅销售预包装食品）。（除依法须经批准的项目外,凭营业执照依法自主开展经营活动）许可项目:生活美容服务。（依法须经批准的项目,经相关部门批准后方可开展经营活动,具体经营项目以相关部门批准文件或许可证件为准）
广东甜橙影视传媒有限公司	影视策划,企业形象策划,电脑图文设计,文化艺术组织策划（不含演出）、商品信息咨询,广告发布、代理、策划、制作,房地产中介服务,会展服务,信息技术咨询服务,体育活动组织策划,其他文化艺术经纪代理;使用自有资金对文化行业进行投资;音视频专业技能培训服务;文化娱乐经纪人,有线广播电视传输服务;广播电视节目制作,网络传播视听节目制作。（依法须经批准的项目,经相关部门批准后方可开展经营活动。）（依法须经批准的项目,经相关部门批准后方可开展经营活动）
佛山市天艺文化传播有限公司	许可项目:音像制品复制;电子出版物复制;电子出版物制作;营业性演出;音像制品制作;出版物零售;出版物批发;出版物互联网销售;广播电视节目制作经营。（依法须经批准的项目,经相关部门批准后方可开展经营活动,具体经营项目以相关部门批准文件或许可证件为准）一般项目:计算机软硬件及辅助设备批发;计算机软硬件及辅助设备零售;电子产品销售;文具用品批发;文具用品零售;数字内容制作服务（不含出版发行）;动漫游戏开发;其他文化艺术经纪代理;软件开发;人工智能应用软件开发;通信设备销售;企业管理咨询;文艺创作;专业设计服务;组织文化艺术交流活动;会议及展览服务;广告设计、代理;广告制作;组织体育表演活动;休闲娱乐用品设备出租;数字创意产品展览展示服务;数字文化创意技术装备销售;数字文化创意内容应用服务;数字文化创意软件开发;国内贸易代理;知识产权服务（专利代理服务除外）;社会经济咨询服务;办公服务;日用电器修理;日用产品修理;鞋帽批发;鞋帽零售;服装服饰批发;服装服饰零售;日用品批发;日用品销售;日用百货销售;互联网销售（除销售需要许可的商品）;版权代理;玩具销售。（除依法须经批准的项目外,凭营业执照依法自主开展经营活动）
星铭汇影（佛山）文化传媒有限公司	一般项目:组织文化艺术交流活动;组织体育表演活动;社会经济咨询服务;广告制作;广告发布;广告设计、代理;会议及展览服务;电影摄制服务;文艺创作;电影制片;文化娱乐经纪人服务;其他文化艺术经纪代理;服装服饰批发;服装服饰出租;服装服饰零售;以自有资金从事投资活动。（除依法须经批准的项目外,凭营业执照依法自主开展经营活动）许可项目:广播电视节目制作经营;电影发行;电影放映;出版物零售;音像制品制作;出版物互联网销售;电子出版物制作。（依法须经批准的项目,经相关部门批准后方可开展经营活动,具体经营项目以相关部门批准文件或许可证件为准）
佛山市生命树文化传播有限公司	一般项目：组织文化艺术交流活动；会议及展览服务；软件开发；网络技术服务；信息咨询服务（不含许可类信息咨询服务）；国内贸易代理；教育咨询服务（不含涉许可审批的教育培训活动）；电子产品销售。（除依法须经批准的项目外，凭营业执照依法自主开展经营活动）许可项目：出版物互联网销售。（依法须经批准的项目，经相关部门批准后方可开展经营活动，具体经营项目以相关部门批准文件或许可证件为准）
亿正嘉（佛山）传媒有限公司	一般项目:电影摄制服务;组织文化艺术交流活动;文艺创作;文化用品设备出租;其他文化艺术经纪代理;文化娱乐经纪人服务;互联网销售（除销售需要许可的商品）;国内贸易代理;企业形象策划;咨询策划服务;项目策划与公关服务;市场营销策划;数字文化创意内容应用服务;企业管理。（除依法须经批准的项目外,凭营业执照依法自主开展经营活动）许可项目:互联网直播服务（不含新闻信息服务、网络表演、网络视听节目）;食品互联网销售;互联网信息服务。（依法须经批准的项目,经相关部门批准后方可开展经营活动,具体经营项目以相关部门批准文件或许可证件为准）
佛山市春晓影视传媒有限公司	电影和影视节目制作,会议及展览服务,企业活动策划,文化艺术交流活动组织、策划（不含演出）,演出经纪代理服务;广告设计、制作、代理、发布;企业管理咨询,会议及展览展示服务,市场调查,仓储服务（不含危险化学品）;教育咨询,企业形象策划;网上销售:食品、服装、玩具、床上用品、化妆品、工艺美术品（象牙及其制品除外）、办公用品、健身器材、电子产品、家用电器、电气设备、计算机软件用配件、摄影器材。（依法须经批准的项目,经相关部门批准后方可开展经营活动。）〓（依法须经批准的项目,经相关部门批准后方可开展经营活动）
广东牛头村新文化传播有限公司	电影及电视节目策划、拍摄、制作、发行;音乐及音乐节目策划、制作、发行;演唱会及商务活动策划、制作、运行;商业演出;明星经纪业务;摄影服务;网络及网站经营。（依法须经批准的项目,经相关部门批准后方可开展经营活动。）〓（依法须经批准的项目,经相关部门批准后方可开展经营活动）
佛山市创轩文化传播有限公司	文化活动组织策划;广告设计、策划、制作、发布;广告牌制作、安装;企业活动策划;企业产品策划与推广;庆典礼仪服务;舞台及布景设计;卖场布置;电子画册设计;商品信息咨询;企业顾问;企业管理咨询;喷画制作;销售:广告材料;通信业务代理（不含基础电信和增值电信）;市场营销策划;信息技术服务;经济信息咨询。（依法须经批准的项目,经相关部门批准后方可开展经营活动。）（依法须经批准的项目,经相关部门批准后方可开展经营活动）
佛山市文旅有限公司	一般项目：电影摄制服务；广告制作；广告发布；广告设计、代理；数字内容制作服务（不含出版发行）；企业形象策划；体育竞赛组织；体育场地设施经营（不含高危险性体育运动）；健身休闲活动；组织体育表演活动；体育赛事策划；体育用品及器材零售；体育用品设备出租；体育中介代理服务；体育经纪人服务；体验式拓展活动及策划；游览景区管理；旅游开发项目策划咨询；旅行社服务网点旅游招徕、咨询服务；票务代理服务；旅客票务代理；游乐园服务；会议及展览服务；休闲观光活动；园区管理服务；组织文化艺术交流活动；文艺创作；其他文化艺术经纪代理；文化娱乐经纪人服务；工艺美术品及收藏品零售（象牙及其制品除外）；玩具、动漫及游艺用品销售；专业设计服务；平面设计；以自有资金从事投资活动。（除依法须经批准的项目外，凭营业执照依法自主开展经营活动）许可项目：广播电视节目制作经营；互联网信息服务；高危险性体育运动（游泳）；旅游业务；舞台工程施工；演出经纪；营业性演出；歌舞娱乐活动。（依法须经批准的项目，经相关部门批准后方可开展经营活动，具体经营项目以相关部门批准文件或许可证件为准）
佛山我赛尔体育文化有限公司	服务:体育文化活动组织、策划及推广,体育产品设计,体育相关技术咨询服务,组织从事体育比赛、体育运动指导活动,体育场馆出租与管理,体育运动培训（不含经营高危险性体育项目）,广告设计、制作、发布、代理;销售:体育用品。（依法须经批准的项目,经相关部门批准后方可开展经营活动。）（依法须经批准的项目,经相关部门批准后方可开展经营活动）
佛山华升文化传媒有限公司	影视节目制作（不含工商登记前置审批项目）;文艺创作与表演;其他文化艺术业;艺术表演场馆;群众文体活动（群众性文艺培训服务除外）;文化活动服务;专业设计服务;广告业;互联网其他信息服务（网上直播服务、网上新媒体服务、网上信息发布服务、手机新媒体服务）;互联网批发;互联网零售（以上项目不含工商登记前置审批项目）;其他农牧产品批发;营养和保健品零售;化妆品及卫生用品零售;百货零售;其他日用品零售;日用家电零售;其他食品零售;体育用品及器材零售;五金、家具及室内装饰材料专门零售。（依法须经批准的项目,经相关部门批准后方可开展经营活动。）（依法须经批准的项目,经相关部门批准后方可开展经营活动）
佛山市环宇星辰文化传媒有限公司	许可项目:电影发行;电视剧制作。（依法须经批准的项目,经相关部门批准后方可开展经营活动,具体经营项目以相关部门批准文件或许可证件为准）一般项目:文艺创作;摄像及视频制作服务;摄影扩印服务;技术服务、技术开发、技术咨询、技术交流、技术转让、技术推广;科普宣传服务;销售代理;广告制作;广告发布（非广播电台、电视台、报刊出版单位）;品牌管理;办公用品销售;日用品销售;服装服饰零售;鞋帽零售;箱包销售;工艺美术品及收藏品零售（象牙及其制品除外）;厨具卫具及日用杂品零售;家具销售;教育咨询服务（不含涉许可审批的教育培训活动）;软件开发;信息技术咨询服务;广告设计、代理;文化娱乐经纪人服务;会议及展览服务;个人互联网直播服务（需备案）;信息咨询服务（不含许可类信息咨询服务）;互联网数据服务;企业形象策划;市场营销策划;企业管理咨询;化妆品零售;日用百货销售;日用家电零售;电子元器件零售;电子产品销售;照相器材及望远镜零售。（除依法须经批准的项目外,凭营业执照依法自主开展经营活动）
佛山市金马文投发展有限公司	一般项目:以自有资金从事投资活动;组织文化艺术交流活动;会议及展览服务;咨询策划服务;文化场馆管理服务;体育场地设施经营（不含高危险性体育运动）;园区管理服务;物业管理;日用品批发;日用品销售;日用百货销售;工艺美术品及礼仪用品销售（象牙及其制品除外）;艺术品代理;专业设计服务;文艺创作;其他文化艺术经纪代理;摄像及视频制作服务;电影摄制服务;票务代理服务;公园、景区小型设施娱乐活动;停车场服务;广告制作;广告发布;广告设计、代理;土地使用权租赁;住房租赁;非居住房地产租赁;企业管理;市政设施管理;政府采购代理服务;物业服务评估;房地产经纪;房地产咨询;资产评估;劳务服务（不含劳务派遣）;食品销售（仅销售预包装食品）;食品互联网销售（仅销售预包装食品）;国内贸易代理;互联网销售（除销售需要许可的商品）。（除依法须经批准的项目外,凭营业执照依法自主开展经营活动）许可项目:建筑智能化系统设计;营业性演出;演出场所经营;演出经纪;广播电视节目制作经营;网络文化经营;食品销售。（依法须经批准的项目,经相关部门批准后方可开展经营活动,具体经营项目以相关部门批准文件或许可证件为准）
佛山市巨石运动健身有限公司	一般项目:健身休闲活动;体育健康服务。（除依法须经批准的项目外,凭营业执照依法自主开展经营活动）许可项目:体育场地设施经营（不含高危险性体育运动）;高危险性体育运动（游泳）。（依法须经批准的项目,经相关部门批准后方可开展经营活动,具体经营项目以相关部门批准文件或许可证件为准）
佛山市科宏文化传播有限公司	一般项目:文艺创作;礼仪服务;组织文化艺术交流活动;社会经济咨询服务;企业形象策划;摄影扩印服务;广告制作;广告设计、代理;市场营销策划;项目策划与公关服务;组织体育表演活动;其他文化艺术经纪代理;体育经纪人服务;文化娱乐经纪人服务;品牌管理;家具销售;服装服饰零售;化妆品零售;互联网销售（除销售需要许可的商品）。（除依法须经批准的项目外,凭营业执照依法自主开展经营活动）
佛山市林信文化传播有限公司	服务:文化活动策划,企业形象策划,广告设计、制作、代理、发布,软件开发;销售:电子产品。（依法须经批准的项目,经相关部门批准后方可开展经营活动）
广东天之道文化传媒有限公司	影视节目制作；文艺创作；文化艺术咨询；群众文化活动策划；大型活动组织策划；会议及展览服务；艺术品鉴定、评估；艺术品、收藏品拍卖（不含象牙及其制品）；对收藏品的投资（不含象牙及其制品）；广告策划、制作、设计、发布；企业营销策划；电子科技领域内的技术开发、技术咨询、技术推广、技术服务；网络平台开发、建设和维护；网站设计；销售：电子产品、机电设备、仪器仪表、通讯器材、电子设备、艺术品（不含象牙及其制品）、图书、音像制品；国内贸易；文物展览（不含国有文物及国家禁止销售的文物，凭有效的文物行政部门批准的文件经营）；酒、饮料及茶叶批发。（依法须经批准的项目，经相关部门批准后方可开展经营活动）
广东乐达传媒有限公司	电影和影视节目制作;广告业;会议、展览及相关服务;其他未列明商务服务业（不含商业保理公司服务）;社会经济咨询。（依法须经批准的项目,经相关部门批准后方可开展经营活动。）（依法须经批准的项目,经相关部门批准后方可开展经营活动）
佛山功夫演艺文化有限公司	文艺创作与表演,体育保障组织,餐饮服务,房地产开发经营,物业管理,游览景区管理,房地产中介服务,体育竞赛组织,园区管理服务,互联网生活服务平台,旅游会展服务,文化会展服务,会议、展览及相关服务。（依法须经批准的项目,经相关部门批准后方可开展经营活动。）（依法须经批准的项目,经相关部门批准后方可开展经营活动）
佛山市陶城报社出版有限公司	陶城报出版、发行（凭有效的许可证经营）;服务:会展展览策划、品牌策划、文化艺术活动交流及策划、企业形象策划、市场营销策划、社会经济咨询、项目投资咨询、会议及展览服务、计算机平面设计,广告设计、制作、代理及发布;货物进出口及技术进出口。（依法须经批准的项目,经相关部门批准后方可开展经营活动。）（依法须经批准的项目,经相关部门批准后方可开展经营活动）
广东省星梦体育产业发展有限公司	对体育行业进行投资,室内体育场所服务,室外人工体育场所服务,体育咨询、体育活动、赛事策划及组织,体育项目培训（不含经营高危险性体育项目）,场地租赁（不含仓储）;批发、零售:体育用品。（依法须经批准的项目,经相关部门批准后方可开展经营活动）
广东粤银集币文化有限公司	一般项目：文艺创作；文化场馆管理服务；数字文化创意内容应用服务；艺（美）术品、收藏品鉴定评估服务；工艺美术品及收藏品零售（象牙及其制品除外）；非物质文化遗产保护；票务代理服务；装帧流通人民币；工艺美术品及礼仪用品销售（象牙及其制品除外）；艺术品代理；文物文化遗址保护服务；平面设计；金属链条及其他金属制品销售；有色金属合金销售；珠宝首饰零售；金银制品销售；食品销售（仅销售预包装食品）；货物进出口；互联网销售（除销售需要许可的商品）。（除依法须经批准的项目外，凭营业执照依法自主开展经营活动）许可项目：拍卖业务；文物销售。（依法须经批准的项目，经相关部门批准后方可开展经营活动，具体经营项目以相关部门批准文件或许可证件为准）
龙凤呈祥影业有限公司	电影和影视节目制作；动画片制作；国内外影视项目策划、发行；国内外文化交流活动组织策划；文化体育活动组织策划；演出经纪代理；影视器材租赁；旅游咨询、旅游项目策划；数据处理和存储服务；广告发布、代理、策划、制作；会议服务、展览展示服务。（依法须经批准的项目，经相关部门批准后方可开展经营活动。）（依法须经批准的项目，经相关部门批准后方可开展经营活动）
佛山市名致知识产权服务有限公司	一般项目:知识产权服务（专利代理服务除外）;商标代理;版权代理;组织文化艺术交流活动;市场营销策划;餐饮管理;企业管理咨询;教育咨询服务（不含涉许可审批的教育培训活动）;企业形象策划;会议及展览服务;品牌管理;信息咨询服务（不含许可类信息咨询服务）;网络技术服务;计算机软硬件及辅助设备零售;电子产品销售;技术服务、技术开发、技术咨询、技术交流、技术转让、技术推广;网络与信息安全软件开发;专业设计服务;科普宣传服务;互联网销售（除销售需要许可的商品）;商业、饮食、服务专用设备销售;计算机软硬件及辅助设备批发;机械电气设备销售;电子专用设备销售;通信设备销售;日用品销售;母婴用品销售;服装服饰零售;鞋帽零售;办公用品销售;化妆品零售;体育用品及器材零售;针纺织品销售;针纺织品及原料销售;日用百货销售;文具用品零售;玩具、动漫及游艺用品销售;仪器仪表销售;家用电器销售;塑料制品销售;汽车装饰用品销售。（除依法须经批准的项目外,凭营业执照依法自主开展经营活动）
佛山市启视文化传播有限公司	一般项目:文艺创作;教育咨询服务（不含涉许可审批的教育培训活动）;健康咨询服务（不含诊疗服务）;组织体育表演活动;组织文化艺术交流活动;家政服务;图书出租;软件开发;体育用品及器材批发;文化用品设备出租;工艺美术品及礼仪用品销售（象牙及其制品除外）;文具用品批发;玩具、动漫及游艺用品销售;教学专用仪器销售;中小学生校外托管服务;电子产品销售。（除依法须经批准的项目外,凭营业执照依法自主开展经营活动）许可项目:餐饮服务（不含酒吧服务）。（依法须经批准的项目,经相关部门批准后方可开展经营活动,具体经营项目以相关部门批准文件或许可证件为准）
佛山五方源视野文化传播有限公司	许可项目:广播电视节目制作经营;电视剧制作;网络文化经营;互联网信息服务;音像制品复制。（依法须经批准的项目,经相关部门批准后方可开展经营活动,具体经营项目以相关部门批准文件或许可证件为准）一般项目:摄像及视频制作服务;电影摄制服务;电影制片;数字内容制作服务（不含出版发行）;项目策划与公关服务;咨询策划服务;信息技术咨询服务;广告制作;广告设计、代理;广告发布;平面设计;图文设计制作;组织文化艺术交流活动;其他文化艺术经纪代理;体育中介代理服务;体育赛事策划;互联网销售（除销售需要许可的商品）;食品销售（仅销售预包装食品）;摄影扩印服务。（除依法须经批准的项目外,凭营业执照依法自主开展经营活动）
宁洋影业（佛山）有限公司	电影和影视节目制作;录音制作;广播电视节目制作;音像制品制作;电影和影视节目发行;电影放映;演出经纪代理服务;文艺创作;文化推广（不含许可经营项目）;文化娱乐经纪人;影视经纪代理服务;音像经纪代理服务;广告的设计、制作、代理、发布;灯光设备租赁;音频和视频设备租赁;照相器材出租服务;娱乐设备出租服务;企业管理服务（不含投资与资产管理）;企业管理咨询服务;翻译服务;销售:乐器;零售:照相器材。（依法须经批准的项目,经相关部门批准后方可开展经营活动。）（依法须经批准的项目,经相关部门批准后方可开展经营活动）
广东朗信文化活动策划有限公司	文化活动组织,文化艺术交流活动策划;企业形象设计;会议服务;礼仪服务;广告设计、制作、代理及发布;;摄影服务;市场调研,市场调查;商务信息咨询服务;公关活动策划;数字作品的数据库管理;云平台服务;供应链管理;电脑图文设计及制作;教育项目与教育科研文献研究与开发;教育软件的研究与开发;教育文化活动组织及策划,教育信息咨询;影视节目制作;销售:工艺品（象牙及其制品除外）、文化用品、办公用品、服装、服饰、婚庆用品、日用品、小礼品。（依法须经批准的项目,经相关部门批准后方可开展经营活动）
佛山市迪特舞蹈艺术有限公司	一般项目:文艺创作;组织文化艺术交流活动;个人商务服务;礼仪服务;文化娱乐经纪人服务;业务培训（不含教育培训、职业技能培训等需取得许可的培训）;其他文化艺术经纪代理;社会经济咨询服务;信息咨询服务（不含许可类信息咨询服务）;咨询策划服务;教育咨询服务（不含涉许可审批的教育培训活动）。（除依法须经批准的项目外,凭营业执照依法自主开展经营活动）许可项目:演出经纪;营业性演出。（依法须经批准的项目,经相关部门批准后方可开展经营活动,具体经营项目以相关部门批准文件或许可证件为准）
佛山市晏奏文化发展有限公司	一般项目:以自有资金从事投资活动;社会经济咨询服务;咨询策划服务;科技中介服务;文具用品零售;工艺美术品及收藏品零售（象牙及其制品除外）;园林绿化工程施工;礼品花卉销售;园艺产品销售;花卉绿植租借与代管理;专业设计服务;广告设计、代理。（除依法须经批准的项目外,凭营业执照依法自主开展经营活动）
佛山市方进电影城有限公司	电影放映；食品经营；出版物批发、零售；电影发行；广播电视节目制作；餐饮服务；儿童室内游戏服务（不含电子游艺）；企业形象策划服务，文化艺术咨询服务，策划创意服务，市场调研服务，制作、发布、代理广告，大型活动组织策划服务，物业管理，房屋租赁（不含仓储）；游艺娱乐用品零售。（依法须经批准的项目，经相关部门批准后方可开展经营活动）
佛山市仲荣企业策划有限公司	服务:企业营销策划,会计咨询服务,文化活动策划,工商登记代理,代理记账,企业管理咨询服务,商标代理,网络技术的研发、转让咨询,数据处理与存储服务,广告设计、制作、代理及发布;销售:办公用品,计算机软硬件及辅助设备,电子产品。（依法须经批准的项目,经相关部门批准后方可开展经营活动）
星环影视娱乐传媒（广东）有限责任公司	许可项目:电影发行;电视剧制作;电视剧发行;互联网游戏服务;游艺娱乐活动;广播电视节目制作经营。（依法须经批准的项目,经相关部门批准后方可开展经营活动,具体经营项目以相关部门批准文件或许可证件为准）一般项目:其他文化艺术经纪代理;文艺创作;组织文化艺术交流活动;广告制作;广告发布;数字内容制作服务（不含出版发行）。（除依法须经批准的项目外,凭营业执照依法自主开展经营活动）
佛山市狮王互娱文化传播有限公司	服务:文化艺术活动交流策划,计算机、网络科技领域内的技术开发、技术转让、技术咨询、技术服务,广告设计、制作、代理及发布,会议会展服务,动漫设计,互联网信息服务;零售:计算机、软硬件及辅助设备。（依法须经批准的项目,经相关部门批准后方可开展经营活动）
佛山市唛醉空间娱乐有限公司	许可项目:歌舞娱乐活动;烟草制品零售;足浴服务。（依法须经批准的项目,经相关部门批准后方可开展经营活动,具体经营项目以相关部门批准文件或许可证件为准）一般项目:食品销售（仅销售预包装食品）;食品互联网销售（仅销售预包装食品）。（除依法须经批准的项目外,凭营业执照依法自主开展经营活动）
佛山市鸿胜堂功夫文化传播有限公司	一般项目:组织文化艺术交流活动;非物质文化遗产保护;文物文化遗址保护服务;健身休闲活动;健康咨询服务（不含诊疗服务）;养生保健服务（非医疗）;中医养生保健服务（非医疗）;数据处理服务;数据处理和存储支持服务;互联网销售（除销售需要许可的商品）。（除依法须经批准的项目外,凭营业执照依法自主开展经营活动）
佛山市凯鑫隆贸易有限公司	一般项目:国内贸易代理;互联网销售（除销售需要许可的商品）;母婴用品销售;日用品出租;日用品销售;日用杂品销售;塑料制品销售;服装服饰零售;服装辅料销售;服装服饰出租;珠宝首饰零售;艺（美）术品、收藏品鉴定评估服务;工艺美术品及收藏品零售（象牙及其制品除外）;家用电器安装服务;电子产品销售。（除依法须经批准的项目外,凭营业执照依法自主开展经营活动）许可项目:货物进出口。（依法须经批准的项目,经相关部门批准后方可开展经营活动,具体经营项目以相关部门批准文件或许可证件为准）
佛山市亚世健身服务有限公司	一般项目:健身休闲活动;体育赛事策划;体育竞赛组织;组织文化艺术交流活动;体育中介代理服务;企业形象策划;物业管理;非居住房地产租赁;租赁服务（不含许可类租赁服务）;人力资源服务（不含职业中介活动、劳务派遣服务）;信息咨询服务（不含许可类信息咨询服务）;体育用品及器材零售;日用百货销售;服装服饰零售;食品销售（仅销售预包装食品）;保健食品（预包装）销售。（除依法须经批准的项目外,凭营业执照依法自主开展经营活动）许可项目:高危险性体育运动（游泳）。（依法须经批准的项目,经相关部门批准后方可开展经营活动,具体经营项目以相关部门批准文件或许可证件为准）
中堂文化（广东）有限公司	一般项目：组织文化艺术交流活动；以自有资金从事投资活动；文化娱乐经纪人服务；会议及展览服务；土地整治服务；礼仪服务；信息系统集成服务；市政设施管理；游览景区管理；企业管理咨询；物业管理；旅游开发项目策划咨询；技术服务、技术开发、技术咨询、技术交流、技术转让、技术推广；住房租赁；广告设计、代理；广告发布；工艺美术品及收藏品零售（象牙及其制品除外）；服装服饰批发；市场营销策划；企业形象策划；市场调查（不含涉外调查）；图文设计制作；体育赛事策划；文化用品设备出租；体育用品及器材零售；日用百货销售；礼品花卉销售；通讯设备销售；食品销售（仅销售预包装食品）。（除依法须经批准的项目外，凭营业执照依法自主开展经营活动）许可项目：演出经纪；建设工程施工；建设工程监理；旅游业务；房地产开发经营；电影放映；电影发行；互联网信息服务；基础电信业务。（依法须经批准的项目，经相关部门批准后方可开展经营活动，具体经营项目以相关部门批准文件或许可证件为准）
佛山市维力美健身管理有限公司	许可项目:体育场地设施经营（不含高危险性体育运动）;高危险性体育运动（游泳）;食品经营。（依法须经批准的项目,经相关部门批准后方可开展经营活动,具体经营项目以相关部门批准文件或许可证件为准）一般项目:健身休闲活动;从事艺术培训的营利性民办培训机构（除面向中小学生开展的学科类、语言类文化教育培训）;文艺创作;信息咨询服务（不含许可类信息咨询服务）。（除依法须经批准的项目外,凭营业执照依法自主开展经营活动）
佛山市粤秀星华文化传播有限公司	一般项目:组织文化艺术交流活动。（除依法须经批准的项目外,凭营业执照依法自主开展经营活动）许可项目:演出经纪;营业性演出;音像制品制作。（依法须经批准的项目,经相关部门批准后方可开展经营活动,具体经营项目以相关部门批准文件或许可证件为准）
广东鸿派文化传播有限公司	服务:文化活动组织策划,企业形象策划,市场营销策划,舞台搭建,广告设计、制作、代理及发布,摄像服务,动漫设计,图文设计及制作,计算机软件设计与开发,视频制作（不含影视制作）,  群众文化活动及体育组织,文化艺术咨询服务,公共关系服务,演出经纪代理服务,影视经纪代理服务,音像经纪代理服务,文化娱乐经纪人,影视文化信息咨询服务;对影视项目进行投资。（依法须经批准的项目,经相关部门批准后方可开展经营活动）
广东债无虑法律咨询有限公司	一般项目:法律咨询（不包括律师事务所业务）;个人信用修复服务;企业信用修复服务;企业信用管理咨询服务;企业信用评级服务;组织文化艺术交流活动;社会经济咨询服务;信息咨询服务（不含许可类信息咨询服务）;咨询策划服务;市场调查（不含涉外调查）;广告制作;广告设计、代理;会议及展览服务;技术服务、技术开发、技术咨询、技术交流、技术转让、技术推广;软件开发;市场营销策划;数据处理和存储支持服务;企业管理咨询;商务代理代办服务;个人商务服务;企业形象策划;教育咨询服务（不含涉许可审批的教育培训活动）;企业管理。（除依法须经批准的项目外,凭营业执照依法自主开展经营活动）
广东君崇网络传媒有限公司	服务:文化艺术活动交流策划,广告设计、制作、代理、发布,企业形象策划,展览展示服务,计算机软硬件开发,网络技术咨询、技术服务、技术转让,网站建设,互联网信息服务,广播电视节目制作,影视、动漫、游戏产品的策划、开发、制作、发行、运营;电子产品、通讯设备、智能化测控设备、量具量仪、机电机床设备、智能化运输设备、计算机软件的研发、生产、销售及技术咨询;货物进出口、技术进出口。（依法须经批准的项目,经相关部门批准后方可开展经营活动）
广东省人人体育文化有限公司	一般项目:体育中介代理服务;体育竞赛组织;组织体育表演活动;体育经纪人服务;体育用品及器材零售;互联网销售（除销售需要许可的商品）;计算机软硬件及辅助设备批发;动漫游戏开发;游艺用品及室内游艺器材销售;玩具、动漫及游艺用品销售;软件开发;摄像及视频制作服务;广告制作;广告发布;广告设计、代理。（除依法须经批准的项目外,凭营业执照依法自主开展经营活动）
立木电影集团有限公司	影视节目制作；电影和广播电视节目发行；商业综合体管理服务；游览景区管理；互联网科技创新平台；工程技术与设计服务；教育辅助服务；建筑工程机械与设备经营租赁；装卸搬运；文化活动策划；广告牌安装；灯光音响工程；批发：舞台设备、演出器材。（依法须经批准的项目，经相关部门批准后方可开展经营活动。）（依法须经批准的项目，经相关部门批准后方可开展经营活动）
安肯集团有限公司	一般项目:技术服务、技术开发、技术咨询、技术交流、技术转让、技术推广;橡胶制品销售;化工产品销售（不含许可类化工产品）;针纺织品及原料销售;家居用品销售;建筑材料销售;建筑装饰材料销售;日用百货销售;办公用品销售;劳动保护用品销售;建筑物清洁服务;专业保洁、清洗、消毒服务;办公设备租赁服务;国内货物运输代理;软件开发;信息技术咨询服务;咨询策划服务;市场营销策划;广告设计、代理;广告制作;招投标代理服务;会议及展览服务;信息咨询服务（不含许可类信息咨询服务）。（除依法须经批准的项目外,凭营业执照依法自主开展经营活动）
巨微控股集团有限公司	控股公司服务;投资与资产管理（实业投资）;广播、电视、电影和录音制作业;运动机织服装制造;汽车、摩托车、零配件和燃料及其他动力销售（危险化学品除外）;商业综合体管理服务;游览景区管理;休闲观光活动;工程技术与设计服务;房地产业;通讯设备批发;金属及金属矿批发;建材批发;建筑装饰和装修业。（依法须经批准的项目,经相关部门批准后方可开展经营活动。）（依法须经批准的项目,经相关部门批准后方可开展经营活动）
佛山乡村俱乐部有限公司	经营高尔夫球场、网球场、游泳池、高尔夫球会馆、会员俱乐部、餐饮、酒吧、商场（零售旅游纪念品、体育器具、日用商品）;自有物业及场地租赁;会议服务;高尔夫球教学培训;活动策划。（依法须经批准的项目,经相关部门批准后方可开展经营活动。）（依法须经批准的项目,经相关部门批准后方可开展经营活动）
松力（广东）传媒集团股份有限公司	演艺及庆典活动策划,影视策划与制作,舞台及灯光音响安装工程;广告设计、制作、发布;国内贸易,货物进出口,技术进出口;批发:舞台设备,制冷设备,办公设备及演出器材。（依法须经批准的项目,经相关部门批准后方可开展经营活动。）（依法须经批准的项目,经相关部门批准后方可开展经营活动）
广东省王者人人电竞文化传媒有限公司	一般项目:摄像及视频制作服务;组织体育表演活动;互联网销售（除销售需要许可的商品）;信息咨询服务（不含许可类信息咨询服务）;动漫游戏开发;图文设计制作;体育中介代理服务;体育竞赛组织;组织文化艺术交流活动;咨询策划服务;企业形象策划;体育赛事策划;市场营销策划;会议及展览服务;体育经纪人服务;教育咨询服务（不含涉许可审批的教育培训活动）;软件开发;日用品销售。（除依法须经批准的项目外,凭营业执照依法自主开展经营活动）
广东冉悦瑜伽服务有限公司	瑜伽健身服务、咨询与培训,文化艺术交流活动的组织与策划,展示展览服务。（依法须经批准的项目,经相关部门批准后方可开展经营活动。）（依法须经批准的项目,经相关部门批准后方可开展经营活动）
广东宝力来健身服务有限公司	健身休闲活动（工商登记前置审批项目除外）;体育场馆管理（工商登记前置审批项目除外）;酒、饮料及茶叶零售。（依法须经批准的项目,经相关部门批准后方可开展经营活动。）（依法须经批准的项目,经相关部门批准后方可开展经营活动）
佛山市南海区碧家文化传播有限公司	一般项目:文艺创作;其他文化艺术经纪代理;社会经济咨询服务;组织文化艺术交流活动;会议及展览服务;专业设计服务;企业管理;摄影扩印服务;票务代理服务;广告制作;广告设计、代理;体育用品及器材批发;日用杂品销售;互联网销售（除销售需要许可的商品）;体育用品及器材零售;电子产品销售;服装辅料销售;国内贸易代理;电影摄制服务;体育赛事策划;数字内容制作服务（不含出版发行）;体育经纪人服务;农副产品销售;食品销售（仅销售预包装食品）;软件开发;技术服务、技术开发、技术咨询、技术交流、技术转让、技术推广;工程和技术研究和试验发展;货物进出口。（除依法须经批准的项目外,凭营业执照依法自主开展经营活动）许可项目:电视剧发行;电影发行;建设工程施工。（依法须经批准的项目,经相关部门批准后方可开展经营活动,具体经营项目以相关部门批准文件或许可证件为准）
广东功夫考拉文化产业股份有限公司	一般项目:组织文化艺术交流活动;其他文化艺术经纪代理;规划设计管理;平面设计;市场营销策划;企业形象策划;旅游开发项目策划咨询;普通露天游乐场所游乐设备制造（不含大型游乐设施）;游艺用品及室内游艺器材制造;玩具制造;体育用品及器材制造;教学用模型及教具制造;以自有资金从事投资活动;社会经济咨询服务;宠物服务（不含动物诊疗）;动物园管理服务;摄像及视频制作服务;信息系统集成服务;知识产权服务（专利代理服务除外）;游艺用品及室内游艺器材销售;普通露天游乐场所游乐设备销售;会议及展览服务;教育咨询服务（不含涉许可审批的教育培训活动）;户外用品销售;玩具、动漫及游艺用品销售;互联网销售（除销售需要许可的商品）;橡胶制品销售;文具用品批发;服装服饰批发;游乐园服务;体育用品及器材批发;体育场地设施工程施工;园林绿化工程施工。（除依法须经批准的项目外,凭营业执照依法自主开展经营活动）许可项目:建设工程设计;建设工程施工;大型游乐设施制造;动物饲养;宠物饲养;演出场所经营。（依法须经批准的项目,经相关部门批准后方可开展经营活动,具体经营项目以相关部门批准文件或许可证件为准）
佛山市南海樵山文化旅游发展有限公司	文艺创作与表演,艺术表演场馆服务,游览景区管理服务,公园管理服务;零售业（工商登记前置审批项目除外）;自有房地产经营活动;其他道路运输辅助服务;图书、报刊零售;图书批发;其他未列明商务服务。（依法须经批准的项目,经相关部门批准后方可开展经营活动。）（依法须经批准的项目,经相关部门批准后方可开展经营活动）
广东中旅（南海）水上乐园有限公司	水上游乐园;游泳池;露天游乐园管理;餐饮服务及管理;物业租赁及管理;停车服务;西岸旅游产业园景区门票代售;酒店管理服务;会议及展览服务;零售:预包装食品;电话充值卡销售;国内贸易。（依法须经批准的项目,经相关部门批准后方可开展经营活动）
佛山市和讯通信工程有限公司	通信工程施工、网络系统集成安装;销售:通信器材;网络设备维护服务;电子、通信与自动控制技术研究、开发;电子产品零售;电子产品批发;通用机械设备零售;电气设备批发;计算机及通讯设备租赁;信息系统集成服务;其他办公设备维修;商品信息咨询服务;计算机网络系统工程服务;仪器仪表修理;信息技术咨询服务。（依法须经批准的项目,经相关部门批准后方可开展经营活动）
广东鑫锘影视文化传播有限公司	制作、复制、发行:广播剧、电视剧、动画片（制作须另申报）、专题、专栏（不含时政新闻类）、综艺;利用互联网经营音乐娱乐产品、游戏产品、艺术品、演出剧（节）目、表演、动漫产品;从事互联网文化产品的展览、比赛活动;设计、制作、发布、代理国内外各类广告;信息服务业务;从事互联网视听节目服务中的电影、电视剧类视听节目及文艺、娱乐、科技、财经、体育、教育等专业类视听节目的汇集、播出服务;销售计算机软件并提供相关技术服务和售后服务;其他电信服务（增值电信服务）。（依法须经批准的项目,经相关部门批准后方可开展经营活动。）（依法须经批准的项目,经相关部门批准后方可开展经营活动）
佛山市美派文化传播有限公司	企业形象设计策划,公关活动策划,赛事活动策划,市场营销策划,舞台艺术造型策划,承办大型活动策划组织,演艺庆典活动策划及咨询;展览展示服务,礼仪服务,文化传播服务,摄影服务;广告设计、制作、发布、代理;网页设计。（依法须经批准的项目,经相关部门批准后方可开展经营活动）
中玉文化传媒有限公司	电影和影视节目制作;广播（广播节目播出服务）;电影和广播电视节目发行;专业化设计服务;录音制作;广告业;社会经济咨询（不含投资咨询、教育咨询）;其他未列明商务服务业;其他文化艺术业（艺术品、美术品、收藏品鉴定服务）;文化活动服务;文化娱乐经纪人;宝石、玉石采选;互联网零售（工商登记前置审批项目除外）;会议及展览服务;贸易代理;应用软件开发;其他软件开发;货物和技术进出口（国家禁止或涉及行政审批的货物和技术进出口除外）;艺术品、收藏品拍卖;以下项目不含象牙及其制品:文艺创作与表演,首饰、工艺品及收藏品批发（文物买卖）,珠宝首饰零售,其他工艺美术品制造。（依法须经批准的项目,经相关部门批准后方可开展经营活动。）〓（依法须经批准的项目,经相关部门批准后方可开展经营活动）
佛山市南海桃园高尔夫俱乐部有限公司	许可项目:体育场地设施经营（不含高危险性体育运动）。（依法须经批准的项目,经相关部门批准后方可开展经营活动,具体经营项目以相关部门批准文件或许可证件为准）一般项目:体育竞赛组织;体育用品及器材零售;住房租赁;非居住房地产租赁;物业管理;广告发布（非广播电台、电视台、报刊出版单位）;技术服务、技术开发、技术咨询、技术交流、技术转让、技术推广。（除依法须经批准的项目外,凭营业执照依法自主开展经营活动）
广东嘉星文化传媒有限公司	许可项目:电视剧制作;互联网新闻信息服务。（依法须经批准的项目,经相关部门批准后方可开展经营活动,具体经营项目以相关部门批准文件或许可证件为准）一般项目:文艺创作;文化娱乐经纪人服务;其他文化艺术经纪代理;社会经济咨询服务;软件开发;信息技术咨询服务;食品互联网销售（仅销售预包装食品）;服装服饰批发;鞋帽批发;化妆品批发;家用电器销售;五金产品批发;服装服饰零售;鞋帽零售;化妆品零售;个人卫生用品销售。（除依法须经批准的项目外,凭营业执照依法自主开展经营活动）
广东正家文化传播有限公司	文艺创作与表演;会议及展览服务;专业化设计服务（文化产业工业设计）;电影和影视节目制作;首饰、工艺品及收藏品批发（象牙及其制品除外）;工艺美术品及收藏品零售（象牙及其制品除外）;其他贸易经纪与代理（货物进出口、技术进出口）;以下项目仅限分支机构经营:金属工艺品制造,博物馆。（依法须经批准的项目,经相关部门批准后方可开展经营活动）
佛山粤路文化传媒有限公司	企业文化交流活动策划,产品外观设计,企业形象策划、设计、制作、发布,代理国内外各类广告,市场调研,企业管理咨询,产品信息咨询,商品信息咨询,电脑制图,平面设计。（依法须经批准的项目,经相关部门批准后方可开展经营活动）
瑞婷健康管理集团（广东）有限公司	一般项目:健康咨询服务（不含诊疗服务）;远程健康管理服务;医学研究和试验发展;人体干细胞技术开发和应用;中草药收购;康复辅具适配服务;健身休闲活动（不含高尔夫球运动）;从事科技培训的营利性民办培训机构（除面向中小学生开展的学科类、语言类文化教育培训）;第二类医疗器械销售。（除依法须经批准的项目外,凭营业执照依法自主开展经营活动）许可项目:医疗服务;药品批发;保健食品销售。（依法须经批准的项目,经相关部门批准后方可开展经营活动,具体经营项目以相关部门批准文件或许可证件为准）
佛山桔子田文化传播有限公司	一般项目:文艺创作;中小学生校外托管服务（不包括从事课余辅导、教育培训、餐饮、住宿类的业务）;社会经济咨询服务;文具用品批发;文具用品零售;教育咨询服务（不含涉许可审批的教育培训活动）;幼儿园外托管服务（不包括从事课余辅导、教育培训、餐饮、住宿类的业务）;人力资源服务（不含职业中介活动、劳务派遣服务）;数字文化创意软件开发;组织文化艺术交流活动;数字内容制作服务（不含出版发行）。（除依法须经批准的项目外,凭营业执照依法自主开展经营活动）
广东可儿文化传播有限公司	动漫影视创作及发行,网络游戏创作及发行,影视创作及发行,文学创作,品牌策划与传播,公关策划与传播,广告设计制作与发布;设计、销售文化创意产品。（依法须经批准的项目,经相关部门批准后方可开展经营活动。）（依法须经批准的项目,经相关部门批准后方可开展经营活动）
佛山市缘喜房车文化有限公司	一般项目:组织文化艺术交流活动;露营地服务;汽车零配件批发;机动车充电销售;汽车新车销售;会议及展览服务;信息咨询服务（不含许可类信息咨询服务）;社会经济咨询服务;税务服务;租赁服务（不含许可类租赁服务）;体育保障组织;汽车旧车销售;组织体育表演活动;休闲娱乐用品设备出租;旅行社服务网点旅游招徕、咨询服务;资产评估;机动车修理和维护。（除依法须经批准的项目外,凭营业执照依法自主开展经营活动）许可项目:机动车检验检测服务;道路货物运输（不含危险货物）。（依法须经批准的项目,经相关部门批准后方可开展经营活动,具体经营项目以相关部门批准文件或许可证件为准）
佛山市南海西樵高尔夫发展有限公司	一般项目:体育场地设施经营（不含高危险性体育运动）;体育竞赛组织;体育用品设备出租;体育用品及器材零售。（除依法须经批准的项目外,凭营业执照依法自主开展经营活动）许可项目:餐饮服务。（依法须经批准的项目,经相关部门批准后方可开展经营活动,具体经营项目以相关部门批准文件或许可证件为准）
时光清莲瑜伽（佛山）有限公司	一般项目:健身休闲活动;企业管理;广告设计、代理;服装服饰零售;体育用品及器材零售;中医养生保健服务（非医疗）;母婴生活护理（不含医疗服务）。（除依法须经批准的项目外,凭营业执照依法自主开展经营活动）。许可项目:体育场地设施经营（不含高危险性体育运动）。（依法须经批准的项目,经相关部门批准后方可开展经营活动,具体经营项目以相关部门批准文件或许可证件为准）
佛山市汇而谱节能设备有限公司	制冷、空调设备制造;电力电子元器件制造;家用制冷电器具制造;家用空气调节器制造;家用通风电器具制造;日用家电批发;管道和设备安装;电气安装;日用电器修理;其他机械设备及电子产品批发。（《佛山市南海区产业导向目录》禁止类项目除外）（依法须经批准的项目,经相关部门批准后方可开展经营活动。）（依法须经批准的项目,经相关部门批准后方可开展经营活动）
美置服务集团有限公司	一般项目：居民日常生活服务；租赁服务（不含许可类租赁服务）；人力资源服务（不含职业中介活动、劳务派遣服务）；商务代理代办服务；园林绿化工程施工；知识产权服务（专利代理服务除外）；广告设计、代理（非广播、电视台、报刊出版单位）；充电控制设备租赁；体验式拓展活动及策划；室内空气污染治理；住房租赁；洗车服务；供冷服务；家政服务；洗染服务；会议及展览服务；园区管理服务；礼仪服务；健身休闲活动；电气设备修理；通讯设备修理；日用产品修理；物业管理；酒店管理；国内贸易代理；房地产经纪；信息技术咨询服务；住宅水电安装维护服务；金属门窗工程施工；物联网应用服务；物联网技术服务；停车场服务；专业保洁、清洗、消毒服务；工程管理服务。（除依法须经批准的项目外，凭营业执照依法自主开展经营活动）许可项目：建设工程施工；住宅室内装饰装修；酒类经营。（依法须经批准的项目，经相关部门批准后方可开展经营活动，具体经营项目以相关部门批准文件或许可证件为准）（以上项目不含烟草及其制品，不涉及外商投资准入特别管理措施）
佛山珠江传媒电视有限公司	一般项目:广告发布;广告设计、代理;平面设计;图文设计制作;专业设计服务;摄像及视频制作服务;电影摄制服务;摄影扩印服务;服装服饰出租;文化娱乐经纪人服务;其他文化艺术经纪代理;组织体育表演活动;体育竞赛组织;组织文化艺术交流活动;会议及展览服务;市场营销策划;体育赛事策划;体验式拓展活动及策划;企业形象策划;咨询策划服务;文艺创作;项目策划与公关服务;婚庆礼仪服务;礼仪服务;社会经济咨询服务;信息咨询服务（不含许可类信息咨询服务）;教育咨询服务（不含涉许可审批的教育培训活动）;业务培训（不含教育培训、职业技能培训等需取得许可的培训）;销售代理;票务代理服务;国内贸易代理;体育中介代理服务;日用杂品销售;互联网销售（除销售需要许可的商品）;食品互联网销售（仅销售预包装食品）;食品销售（仅销售预包装食品）;食用农产品零售;食用农产品批发;新鲜水果零售;新鲜水果批发;新鲜蔬菜零售;新鲜蔬菜批发;鲜肉零售;鲜肉批发;鲜蛋零售;鲜蛋批发;水产品零售;水产品批发;宠物食品及用品零售;宠物食品及用品批发;服装服饰零售;服装服饰批发;鞋帽零售;鞋帽批发;化妆品零售;化妆品批发;厨具卫具及日用杂品零售;厨具卫具及日用杂品批发;医护人员防护用品零售;医护人员防护用品批发;自行车及零配件零售;自行车及零配件批发;文具用品零售;文具用品批发;体育用品及器材零售;体育用品及器材批发;珠宝首饰零售;珠宝首饰批发;工艺美术品及收藏品零售（象牙及其制品除外）;工艺美术品及收藏品批发（象牙及其制品除外）;乐器零售;乐器批发;照相器材及望远镜零售;照相器材及望远镜批发;日用家电零售;家用电器销售;五金产品零售;五金产品批发;计算机软硬件及辅助设备零售;计算机软硬件及辅助设备批发;电子元器件零售;电子元器件批发;日用品销售;日用品批发;家具销售;通讯设备销售;电动自行车销售;针纺织品销售;建筑装饰材料销售;建筑材料销售;货物进出口;技术进出口;广播影视设备销售;广播电视传输设备销售;音响设备销售;数字文化创意技术装备销售;电子产品销售;网络设备销售;信息系统集成服务;技术服务、技术开发、技术咨询、技术交流、技术转让、技术推广。（除依法须经批准的项目外,凭营业执照依法自主开展经营活动）许可项目:广播电视节目制作经营;营业性演出;演出经纪;互联网新闻信息服务;酒类经营;电气安装服务。（依法须经批准的项目,经相关部门批准后方可开展经营活动,具体经营项目以相关部门批准文件或许可证件为准）
佛山珠江传媒广播有限公司	提供网络视听及信息服务,影视节目的制作、转让,音像制品的制作、销售,承办各类演出及经纪业务,文化交流传播,策划制作各类文化活动,广告设计、制作、发布、代理;信息咨询服务,旅游项目咨询服务;互联网产品开发及运营,电子商务、国内贸易;展会展览服务。（依法须经批准的项目,经相关部门批准后方可开展经营活动）
广东省星浩影视制作有限公司	一般项目:电影摄制服务;摄像及视频制作服务;摄影扩印服务;数字内容制作服务（不含出版发行）;其他文化艺术经纪代理;影视美术道具置景服务;租赁服务（不含许可类租赁服务）;文化用品设备出租;专业设计服务;个人互联网直播服务;信息咨询服务（不含许可类信息咨询服务）;信息技术咨询服务;咨询策划服务;软件开发;广告制作;广告发布;广告设计、代理;平面设计;企业形象策划;礼仪服务;会议及展览服务;文艺创作;组织文化艺术交流活动;项目策划与公关服务。（除依法须经批准的项目外,凭营业执照依法自主开展经营活动）许可项目:广播电视节目制作经营;音像制品制作;网络文化经营。（依法须经批准的项目,经相关部门批准后方可开展经营活动,具体经营项目以相关部门批准文件或许可证件为准）
佛山泛德文化艺术有限公司	一般项目:组织文化艺术交流活动;市场营销策划;文艺创作;教育咨询服务（不含涉许可审批的教育培训活动）;教育教学检测和评价活动;幼儿园外托管服务;企业管理咨询;企业形象策划;乐器维修、调试;乐器批发;音响设备销售;文化用品设备出租;玩具销售;广告制作;广告发布;广告设计、代理。（除依法须经批准的项目外,凭营业执照依法自主开展经营活动）
佛山市顺德区建设工程质量安全监督检测中心有限公司	从事建筑质量监测（期限以许可证为准）。（依法须经批准的项目,经相关部门批准后方可开展经营活动。）（依法须经批准的项目,经相关部门批准后方可开展经营活动）
佛山市财神酒店有限公司	以下经营项目限于酒店第一期建筑工程内:住宿服务、餐饮服务（凭有效的许可证经营）、商场（限可配套零售,不含法律、行政法规以及国务院决定禁止或应经许可经营的项目）、商务中心、健身房、桌球室,以下经营项目限于酒店副楼首、二层内:蒸气浴;物业管理、小区配套服务;票务代理服务;沐足、保健按摩服务;停车场管理服务;在佛山市顺德区乐从镇乐从居委会乐从大道东B82号地块从事普通住宅开发、销售及提供相关的售后服务,土地使用权面积为25966.55平方米（以上项目不涉及外商投资准入特别管理措施）。（依法须经批准的项目,经相关部门批准后方可开展经营活动。）〓（依法须经批准的项目,经相关部门批准后方可开展经营活动）
广东君兰和玥会商务管理有限公司	一般项目:企业管理咨询;体育竞赛组织;体育赛事策划;体育用品及器材零售;市场调查（不含涉外调查）;社会经济咨询服务;会议及展览服务;组织文化艺术交流活动;市场营销策划;小微型客车租赁经营服务;洗烫服务;健身休闲活动;养生保健服务（非医疗）;珠宝首饰零售;工艺美术品及收藏品零售（象牙及其制品除外）;食品销售（仅销售预包装食品）;初级农产品收购;水产品收购;休闲娱乐用品设备出租;非居住房地产租赁。（除依法须经批准的项目外,凭营业执照依法自主开展经营活动）许可项目:体育场地设施经营（不含高危险性体育运动）;餐饮服务;理发服务;餐饮服务（不产生油烟、异味、废气）;食品销售;酒类经营;烟草制品零售;货物进出口;技术进出口;高危险性体育运动（游泳）;游艺娱乐活动。（依法须经批准的项目,经相关部门批准后方可开展经营活动,具体经营项目以相关部门批准文件或许可证件为准）
广东恰好教育投资股份有限公司	教育行业投资，教育信息咨询服务、夏令营、冬令营的组织策划、企事业单位外出考察交流活动的组织与策划、研学旅行活动组织策划服务（以上项目不含涉许可审批的教育培训活动），心理咨询服务（不含诊疗服务），文化艺术交流策划，文化活动组织策划，户外拓展活动策划，会议及展览服务，网站的建设与推广，信息系统集成服务、数据处理和存储支持服务，人力资源服务，研学教育实践基地建设，教育软件、教学仪器、教学设备、办公用品的研发和销售，科普产品的展示和销售。（依法须经批准的项目，经相关部门批准后方可开展经营活动。）（依法须经批准的项目，经相关部门批准后方可开展经营活动）
广东家家乐文化产业有限公司	文化艺术交流策划;市场营销策划;展览展示服务;企业管理咨询;计算机软件开发;企业形象策划;项目管理和策划;制造业产业项目咨询;建筑工程设计和咨询;房产中介服务;房产经纪和项目策划;承接室内设计和装饰工程;家政服务（不含劳务派遣）;国内旅游业务（凭有效许可证经营）;设计、制作、发布广告。（依法须经批准的项目,经相关部门批准后方可开展经营活动）
佛山市雅典广告传媒有限公司	设计、制作、代理、发布国内各类广告,室内装饰设计服务及工程安装服务。〓（依法须经批准的项目,经相关部门批准后方可开展经营活动）
广东新天成香云纱生态文化开发有限公司	对香云纱文化产业的开发;艺术文化的推广;对香云纱文化产业旅游商贸、饮食、娱乐、酒店、主题公园、游乐园进行投资;房地产开发经营、物业管理、房地产中介服务、自有房地产经营活动;销售:农副产品;种植:蔬果、花卉、苗木（种植地址另设）。（依法须经批准的项目,经相关部门批准后方可开展经营活动）
佛山市童尚文化传媒有限公司	文化体育娱乐活动与经纪代理服务;文化艺术交流活动策划;文化艺术活动咨询服务;企业形象策划;影视制作;文艺表演;设计、制作、代理国内各类广告;多媒体设计服务;摄影服务;国内商业、物资供销业。（依法须经批准的项目,经相关部门批准后方可开展经营活动。）（依法须经批准的项目,经相关部门批准后方可开展经营活动）
佛山市集韵置业有限公司	许可项目:房地产开发经营。（依法须经批准的项目,经相关部门批准后方可开展经营活动,具体经营项目以相关部门批准文件或许可证件为准）一般项目:物业管理;非居住房地产租赁;商业综合体管理服务;广告发布（非广播、电视台、报刊出版单位）;健康咨询服务（不含诊疗服务）;体育健康服务。（除依法须经批准的项目外,凭营业执照依法自主开展经营活动）（以上项目不涉及外商投资准入特别管理措施）。
广东好啦传媒有限公司	一般项目:数字内容制作服务（不含出版发行）;信息技术咨询服务;化妆品零售;服装服饰零售;互联网销售（除销售需要许可的商品）;厨具卫具及日用杂品批发;日用家电零售;家居用品销售;家具销售;针纺织品销售;日用品销售;母婴用品销售;钟表销售;箱包销售;户外用品销售;家用视听设备销售;皮革、毛皮及其制品加工专用设备销售;照相器材及望远镜批发;工艺美术品及收藏品零售（象牙及其制品除外）;个人卫生用品销售;鞋帽批发;日用百货销售;家用电器销售;智能家庭消费设备制造;软件销售;办公设备耗材销售;纸浆销售;照相机及器材销售;音响设备销售;纸制品销售;门窗销售;智能车载设备销售;五金产品批发;钟表与计时仪器销售;医用口罩批发;办公设备销售;艺术品代理;寄卖服务;贸易经纪;销售代理;宠物食品及用品批发;办公用品销售;建筑材料销售;电子产品销售;互联网数据服务;数字文化创意内容应用服务;物联网应用服务;采购代理服务;供应链管理服务;企业形象策划;会议及展览服务;包装服务;图文设计制作;广告制作;品牌管理;企业管理;市场调查（不含涉外调查）;市场营销策划;教育咨询服务（不含涉许可审批的教育培训活动）;广告设计、代理。（除依法须经批准的项目外,凭营业执照依法自主开展经营活动）许可项目:食品经营;货物进出口;技术进出口。（依法须经批准的项目,经相关部门批准后方可开展经营活动,具体经营项目以相关部门批准文件或许可证件为准）
佛山市顺德区号鹰运动发展有限公司	一般项目:体育赛事策划;体育经纪人服务;体育竞赛组织;组织体育表演活动;组织文化艺术交流活动;会议及展览服务;信息咨询服务（不含许可类信息咨询服务）;从事体育培训的营利性民办培训机构（除面向中小学生开展的学科类、语言类文化教育培训）;体育用品设备出租;广告发布（非广播电台、电视台、报刊出版单位）;体育用品及器材零售;体育用品及器材批发;体育场地设施工程施工;物业管理;企业管理。（除依法须经批准的项目外,凭营业执照依法自主开展经营活动）许可项目:体育场地设施经营（不含高危险性体育运动）;停车场服务;高危险性体育运动（游泳）。（依法须经批准的项目,经相关部门批准后方可开展经营活动,具体经营项目以相关部门批准文件或许可证件为准）
广东一止上传媒有限公司	文化交流活动服务（不含演出经纪）;文化艺术咨询服务;物业管理服务;房地产中介服务;展览展示服务;摄影服务;市场调查;旅游信息咨询服务（不含旅行社业务）;商务信息咨询服务;企业管理咨询;品牌策划推广服务;餐饮服务（凭有效经营许可证经营）;国内商业、物资供销业;货物或技术进出口（国家禁止或涉及行政审批的货物和技术进出口除外）。（依法须经批准的项目,经相关部门批准后方可开展经营活动。）〓（依法须经批准的项目,经相关部门批准后方可开展经营活动）
佛山市顺德区均安碧桂园高尔夫俱乐部有限公司	经营国际标准高尔夫球场及其配套设施;花卉苗木培植、销售。（依法须经批准的项目,经相关部门批准后方可开展经营活动）（依法须经批准的项目,经相关部门批准后方可开展经营活动）
广东共赢影视传媒有限公司	影视制作、影视发行;演出经纪代理服务,大型活动组织策划服务（以上涉及许可的凭有效许可证经营）;舞台表演艺术指导服务;个人形象设计服务;设计、制作、代理、发布:国内各类广告。（依法须经批准的项目,经相关部门批准后方可开展经营活动）〓（依法须经批准的项目,经相关部门批准后方可开展经营活动）
佛山市楚雁文化传播有限公司	一般项目：文艺创作；教育咨询服务（不含涉许可审批的教育培训活动）；中小学生校外托管服务；科技中介服务；乐器零配件销售；乐器维修、调试；乐器零售；乐器批发；体育保障组织；人工智能应用软件开发。（除依法须经批准的项目外，凭营业执照依法自主开展经营活动）许可项目：艺术考级活动。（依法须经批准的项目，经相关部门批准后方可开展经营活动，具体经营项目以相关部门批准文件或许可证件为准）
佛山市圣尔曼健身有限公司	健身服务。（依法须经批准的项目,经相关部门批准后方可开展经营活动）（依法须经批准的项目,经相关部门批准后方可开展经营活动）
广东爱迪斯教育发展有限公司	发展教育事业及与教育相关的产业；文化活动策划；物业管理，物业租赁。（依法须经批准的项目，经相关部门批准后方可开展经营活动）（依法须经批准的项目，经相关部门批准后方可开展经营活动）
佛山市演出有限公司	许可项目:营业性演出;演出经纪;演出场所经营;出版物零售;酒类经营;食品销售。（依法须经批准的项目,经相关部门批准后方可开展经营活动,具体经营项目以相关部门批准文件或许可证件为准）一般项目:组织文化艺术交流活动;其他文化艺术经纪代理;文化娱乐经纪人服务;市场营销策划;体育赛事策划;组织体育表演活动;项目策划与公关服务;票务代理服务;旅客票务代理;广告设计、代理;音响设备销售;照明器具销售;信息技术咨询服务;旅行社服务网点旅游招徕、咨询服务;第二类医疗器械销售;国内贸易代理;互联网销售（除销售需要许可的商品）;专业设计服务;软件开发;广告发布;文化用品设备出租;商务代理代办服务;食品销售（仅销售预包装食品）。（除依法须经批准的项目外,凭营业执照依法自主开展经营活动）
佛山市高明银海高尔夫球俱乐部有限公司	建设、经营高尔夫球场、狩猎场、会员俱乐部及娱乐、健身、餐饮等服务设施,商场以及零售烟、酒、饮料（涉及许可经营的凭许可证经营）。（依法须经批准的项目,经相关部门批准后方可开展经营活动。）（依法须经批准的项目,经相关部门批准后方可开展经营活动）
广东宏马汇体育有限公司	一般项目:体育竞赛组织;体育保障组织;体验式拓展活动及策划;健身休闲活动;体育用品及器材零售。（除依法需经批准得项目外,凭营业执照依法自主开展经营活动）。许可项目:餐饮服务。（依法须经批准的项目,经相关部门批准后方可开展经营活动,具体经营项目以相关部门批准文件或许可证件为准）。
广东鹭湖体育有限公司	许可项目:经营营业性射击场所;射击竞技体育运动;货物进出口;发电、输电、供电业务。（依法须经批准的项目,经相关部门批准后方可开展经营活动,具体经营项目以相关部门批准文件或许可证件为准）一般项目:体育用品及器材零售;休闲观光活动;机械设备租赁;土地使用权租赁。（除依法需经批准的项目外,凭营业执照依法自主开展经营活动）
佛山市老庄文化艺术传播有限公司	文化传播、文化艺术交流、策划咨询服务；持有效审批证件从事营业性演出；广告设计、制作、代理发布国内广告、企业形象设计；艺术品收藏与投资。（依法须经批准的项目，经相关部门批准后方可开展经营活动）
佛山市高明泰康山旅游开发有限公司	农业生态、旅游、休闲、度假、水上乐园、小型游船和竹排水路行进观光、缆车观光、娱乐、运动;住宿、餐饮、（法律、行政法规禁止的项目除外,法律、行政法规限制的项目须取得行政许可后方可经营）。零售:预包装食品、乳制品（不含婴幼儿配方乳粉）、酒类（以上项目须凭有效许可证经营）。农业种植、销售,水产养殖、销售,休闲度假养生,园林工程施工,装饰装潢工程。（依法须经批准的项目,经相关部门批准后方可开展经营活动。）（依法须经批准的项目,经相关部门批准后方可开展经营活动）
佛山市远东名都酒店有限公司	一般项目:酒店管理;养生保健服务（非医疗）;非居住房地产租赁。（除依法须经批准的项目外,凭营业执照依法自主开展经营活动）许可项目:歌舞娱乐活动;足浴服务;酒吧服务（不含演艺娱乐活动）。（依法须经批准的项目,经相关部门批准后方可开展经营活动,具体经营项目以相关部门批准文件或许可证件为准）
广东省鸿都门文化发展有限公司	文艺创作与表演;其他未列明商务服务业（大型活动组织服务）;社会经济咨询（企业管理咨询服务、文化艺术咨询服务、策划创意服务）;会议及展览服务;旅游观光;游览景区管理;中药材种植;销售:盆栽、花草苗木。（依法须经批准的项目,经相关部门批准后方可开展经营活动）
广东省玄黄体育发展有限公司	体育组织（体育项目组织服务、体育运动训练指导服务）；其他体育（体育文化推广服务）；体育经纪人；体育培训（工商登记前置审批项目除外）；其他未列明商务服务业（大型活动组织服务）；销售：体育用品、体育器材。（依法须经批准的项目，经相关部门批准后方可开展经营活动）
佛山市高明巨人网络有限公司	互联网上网服务（仅限本公司分支机构持有效《网吧连锁企业认定证书》经营）;承接网络工程,互联网技术的应用和推广;电子计算机及配件,办公设备零售;代售火车票、飞机票;预包装食品零售（仅限于分支机构经营）;国内贸易（法律、行政法规禁止经营的项目除外,法律、行政法规限制经营的项目须取得许可后方可经营）。（依法须经批准的项目,经相关部门批准后方可开展经营活动）
广东君锐影视传媒有限公司	许可项目：电影发行；演出经纪；营业性演出。一般项目：电影摄制服务；广告发布（非广播电台、电视台、报刊出版单位）；广告设计、代理；文化娱乐经纪人服务。
佛山德艺和艺术培训有限公司	艺术培训;企业管理咨询服务;广告设计、制作、发布;会议展览服务;商业管理;体育运动咨询服务;营养健康咨询服务;商品信息咨询服务;文化活动的组织与策划、文化艺术咨询服务、文化艺术竞赛活动的组织策划、文化艺术讲座活动的组织策划、文化艺术交流活动的组织;营业性文艺演出;舞台艺术造型策划;企业形象策划;销售:文化用品、工艺品、日用百货。（依法须经批准的项目,经相关部门批准后方可开展经营活动）
佛山市佳兆业文化体育有限公司	文化体育活动策划,票务代理,商务信息咨询服务;展览、展示策划;投资兴办实业;体育赛事推广业务;持有效审批证件从事营业性演出;体育用品、健身器材的技术开发与销售;文化用品、工艺美术品、工艺礼品的销售,国内贸易;广告制作及发布;物业租赁;物业管理,持有效审批证件从事高危险性体育项目（游泳池经营）;体育场馆租赁服务;设施设备经营管理及维修、维护;全民健身推广、指导服务;文化艺术培训;体育培训,食品经营。（依法须经批准的项目,经相关部门批准后方可开展经营活动。）（依法须经批准的项目,经相关部门批准后方可开展经营活动）
广东太哲城具艺术发展有限公司	一般项目:艺（美）术品、收藏品鉴定评估服务;会议及展览服务;数字文化创意内容应用服务;非物质文化遗产保护;组织文化艺术交流活动;互联网销售（除销售需要许可的商品）;信息系统集成服务;市场营销策划;文艺创作;专业设计服务;城乡市容管理;工程管理服务;园林绿化工程施工;建筑装饰材料销售;金属结构制造;竹制品制造;玻璃纤维增强塑料制品制造;工艺美术品及礼仪用品制造（象牙及其制品除外）;数字文化创意技术装备销售。（除依法须经批准的项目外,凭营业执照依法自主开展经营活动）许可项目:互联网信息服务;建设工程设计;建设工程施工;住宅室内装饰装修;艺术品进出口。（依法须经批准的项目,经相关部门批准后方可开展经营活动,具体经营项目以相关部门批准文件或许可证件为准）。（除依法须经批准的项目外,凭营业执照依法自主开展经营活动）
佛山市天梵文化传播策划有限公司	文化活动组织策划服务、企业形象策划、舞台造型策划服务、婚礼策划服务、房地产营销策划服务、品牌推广服务、展览展示服务、会议服务、庆典礼仪服务、摄影服务、翻译服务、商务信息咨询服务、舞台设备租赁、明星经纪代理,电脑图文设计制作、广告设计、制作,代理发布国内广告,视频制作,营业性演出,大型立柱广告牌制作安装,网站设计开发;承接:灯光、音响工程、室内外装饰工程、城市园林绿化工程、市政工程、防盗监控工程,道路交通护栏、标牌、标线设计施工;零售:装饰材料、玩具,工艺品、电子产品。（依法须经批准的项目,经相关部门批准后方可开展经营活动）
佛山市高明区方中娱乐有限公司	娱乐场所（KTV）、公共场所经营（足浴）、保健按摩服务;食品经营。（依法须经批准的项目,经相关部门批准后方可开展经营活动）
广东沧龙体育管理有限公司	体育健身服务、体育赛事组织策划、文化艺术交流活动策划、舞台造型策划、体育运动咨询服务、体育经纪人服务;体育场地租赁服务;旅游观光服务;研发、生产、销售、安装、租赁:体育用品及器材、服饰;安装、维护:健身器材;承接:灯光音响电器工程;生产、销售:工艺品;食品经营;国内贸易;旅馆业;种植:苗木、花卉、蔬菜、水果、农产品;水产养殖。（依法须经批准的项目,经相关部门批准后方可开展经营活动）
佛山市旺旅旅游管理有限公司	旅游项目管理服务;娱乐场所（游乐园服务）;高危险性体育项目经营（游泳池）。（依法须经批准的项目,经相关部门批准后方可开展经营活动）
佛山市众沃体育服务有限公司	健身服务;体育赛事组织策划服务、文化活动组织策划服务、舞台造型策划服务、体育信息咨询服务、体育经纪服务;旅游观光服务;体育场地租赁;销售、安装、租赁:体育用品、体育器材;销售:服装。（依法须经批准的项目,经相关部门批准后方可开展经营活动）
广东宝乐奇思文化传播有限公司	其他文化艺术业；文化活动组织策划服务、企业活动策划服务、企业形象策划服务、市场营销策划服务、展览展示服务、庆典礼仪服务；销售：玩具、教学用品、文化用品、美术用品、日用品、工艺品、乐器、服装。（依法须经批准的项目，经相关部门批准后方可开展经营活动）
佛山市力迈健身有限公司	休闲健身活动（健身服务）;销售:体育用品。（依法须经批准的项目,经相关部门批准后方可开展经营活动）
广东明晖体育产业发展有限公司	体育产业及文化旅游的规划设计、开发、建设和运营；体育场馆场地的规划建设和运营；运动康复理疗及康养产业的规划建设和经营；文娱及体育、武术赛事活动的组织、策划与执行；文化艺术培训（工商登记前置审批项目除外）；体育培训（工商登记前置审批项目除外）；体育用品销售。（依法须经批准的项目，经相关部门批准后方可开展经营活动。）（依法须经批准的项目，经相关部门批准后方可开展经营活动）
佛山市高明区高建电影发展有限公司	对影视业的投资;放映、发行电影;录像、演出;场地租赁、演出设备租赁、物业租赁、车辆停放服务;文化活动组织策划、礼仪服务、明星经纪代理、展览展示服务;广告设计、制作、代理发布国内广告;复印服务。（依法须经批准的项目,经相关部门批准后方可开展经营活动。）（依法须经批准的项目,经相关部门批准后方可开展经营活动）
佛山凌耀文化传媒有限公司	许可项目:电影发行;餐饮服务;酒吧服务（不含演艺娱乐活动）;高危险性体育运动（游泳）;各类工程建设活动;安全系统监控服务;食品经营;林木种子生产经营;体育场地设施经营（不含高危险性体育运动）。（依法须经批准的项目,经相关部门批准后方可开展经营活动,具体经营项目以相关部门批准文件或许可证件为准）一般项目:广告制作;广告发布（非广播电台、电视台、报刊出版单位）;露营地服务;健身休闲活动;礼仪服务;项目策划与公关服务;园林绿化工程施工;旅客票务代理;体育场地设施工程施工;休闲娱乐用品设备出租;社会经济咨询服务;旅行社服务网点旅游招徕、咨询服务;房地产经纪;国内贸易代理;游乐园服务;花卉种植;水果种植;园艺产品种植;农业园艺服务;农作物栽培服务;物业管理;酒店管理;知识产权服务;经营民宿;住房租赁;非居住房地产租赁;互联网销售（除销售需要许可的商品）;母婴用品销售;家用电器销售;园艺产品销售;化工产品销售（不含许可类化工产品）;电子产品销售;办公用品销售;建筑材料销售;卫生洁具销售;照明器具销售;服装服饰零售;五金产品零售;鞋帽零售。（除依法须经批准的项目外,凭营业执照依法自主开展经营活动）
佛山市佛林体育文化有限公司	体育组织（体育组织项目服务、体育运动训练指导服务）;其他体育（体育文化推广服务）;体育经纪人;体育场馆（室内体育场所服务、室外人工体育场所服务）;体育培训（工商登记前置审批项目除外）;其他未列明商务服务业（票务服务）;销售:体育用品、服装、鞋、玩具。（依法须经批准的项目,经相关部门批准后方可开展经营活动）
佛山市高明七星岗游乐有限公司	游乐活动服务（凭有效《特种设备使用登记证》经营,不含游艺服务）;游泳场服务;游船租赁,零售:预包装食品、乳制品（不含婴幼儿配方乳粉）。（依法须经批准的项目,经相关部门批准后方可开展经营活动）
佛山天天体育有限公司	全民健身科技服务;竞技体育科技服务;体育工程科技服务;新材料技术开发服务;新材料技术推广服务;新材料技术咨询、交流服务;新材料技术转让服务;体育器材装备安装服务;运动场馆服务（游泳馆除外）;室内体育场、娱乐设施工程服务;室外体育设施工程施工;体育、休闲娱乐工程设计服务;体育运动咨询服务;体育器材及配件制造;其他体育用品制造;体育用品及器材批发;体育用品及器材零售;橡胶板、管、带制造;日用及医用橡胶制品制造;橡胶粘带制造;充气橡胶制品制造;橡胶减震制品制造;硬质橡胶制品制造;橡胶加工专用设备制造;橡胶制品批发;货物进出口（专营专控商品除外）;技术进出口;（依法须经批准的项目，经相关部门批准后方可开展经营活动）
佛山市高明区安泰生态农业旅游发展有限公司	花卉种植、水产养殖、观光游乐;持有效审批证件从事餐饮服务。（依法须经批准的项目,经相关部门批准后方可开展经营活动）
佛山博宇文化传媒有限公司	影视制作,影视拍摄场地、道具、摄影器材、服装租赁,非物质文化遗产保护和开发,文化产品开发和推广,文化艺术咨询服务（不含教育咨询）,文化研究、推广（不含许可经营项目）,文艺创作服务,电脑喷绘、晒图服务,名片印制服务,会展及展览服务,人力资源服务（不含劳务派遣）,舞台表演策划和执行,品牌策划,新媒体运营策划,企业管理咨询服务,策划创意服务,市场营销策划服务,市场调研服务,公共关系服务,媒介投放代理,广告设计、制作,计算机软件服务,计算机网络系统工程服务,计算机技术开发、技术服务,软件测试服务,软件开发,软件技术推广服务,网络技术的研究和开发,网络信息技术推广服务,旅游会展服务;企业管理服务。（依法须经批准的项目,经相关部门批准后方可开展经营活动。）（依法须经批准的项目,经相关部门批准后方可开展经营活动）
佛山市司南文化传播有限公司	其他文化艺术业;文化活动组织策划服务,文艺创作与表演;其他未列明商务服务业（舞台造型策划服务、市场营销策划服务、公司礼仪服务）,会议及展览服务,社会经济咨询（企业管理咨询服务、商务信息咨询服务、企业形象策划服务）;广告设计、制作;销售、维修:乐器;销售:服装、鞋、帽、家具、玩具、母婴用品、日用百货、木制品、塑料制品（以上不含危险化学品）。（依法须经批准的项目,经相关部门批准后方可开展经营活动）（依法须经批准的项目,经相关部门批准后方可开展经营活动）
佛山市坤厚影视传媒文化有限公司	一般项目：电影摄制服务；租借道具活动；影视美术道具置景服务；文化用品设备出租；服装服饰出租；摄影扩印服务；版权代理；组织文化艺术交流活动；企业形象策划；市场营销策划；广告设计、代理；广告制作；广告发布（非广播电台、电视台、报刊出版单位）；会议及展览服务；市场调查（不含涉外调查）；摄像及视频制作服务；翻译服务；礼仪服务；婚庆礼仪服务；项目策划与公关服务；餐饮管理；文艺创作；从事艺术培训的营利性民办培训机构（除面向中小学生开展的学科类、语言类文化教育培训）；数字内容制作服务（不含出版发行）；体育竞赛组织；动漫游戏开发；互联网销售（除销售需要许可的商品）；企业管理咨询；票务代理服务；组织体育表演活动；体育赛事策划；体育经纪人服务；文化娱乐经纪人服务；体育中介代理服务；体育用品及器材零售；计算机软硬件及辅助设备零售；通信设备销售；计算机软硬件及辅助设备批发；国内货物运输代理。（除依法须经批准的项目外，凭营业执照依法自主开展经营活动）许可项目：电影放映；电视剧制作；电视剧发行；电影发行；音像制品制作；互联网上网服务；互联网信息服务；网络文化经营。（依法须经批准的项目，经相关部门批准后方可开展经营活动，具体经营项目以相关部门批准文件或许可证件为准）。
广东强初传媒有限公司	一般项目:摄像及视频制作服务;广告设计、代理;广告发布;网络技术服务;商务代理代办服务;市场营销策划;企业形象策划;专业设计服务;业务培训（不含教育培训、职业技能培训等需取得许可的培训）;咨询策划服务;互联网销售（除销售需要许可的商品）;文化娱乐经纪人服务;办公设备销售;软件销售;照相机及器材销售;通信设备销售。（除依法须经批准的项目外,凭营业执照依法自主开展经营活动）
佛山明晖文化传播有限公司	一般项目:文艺创作;广告制作;广告发布（非广播电台、电视台、报刊出版单位）;广告设计、代理;电影摄制服务;体育竞赛组织;体育赛事策划;组织体育表演活动;物业管理;酒店管理。（除依法须经批准的项目外,凭营业执照依法自主开展经营活动）许可项目:营业性演出;体育场地设施经营（不含高危险性体育运动）;停车场服务;高危险性体育运动（游泳）。（依法须经批准的项目,经相关部门批准后方可开展经营活动,具体经营项目以相关部门批准文件或许可证件为准）
佛山智好达档案管理有限公司	一般项目:承接档案服务外包;数据处理和存储支持服务;办公服务;会议及展览服务;信息技术咨询服务;广告制作;广告发布;仓储设备租赁服务;计算机及办公设备维修;办公设备销售;办公用品销售;安防设备销售;计算机软硬件及辅助设备批发;消防器材销售;消防技术服务;租赁服务（不含许可类租赁服务）;家具销售。（除依法须经批准的项目外,凭营业执照依法自主开展经营活动）许可项目:建设工程施工;特定印刷品印刷;印刷品装订服务;包装装潢印刷品印刷。（依法须经批准的项目,经相关部门批准后方可开展经营活动,具体经营项目以相关部门批准文件或许可证件为准）
佛山市高明塘伙旅游生态乐园有限公司	康体娱乐健身服务、生态观光服务；餐饮服务（不含凉菜、裱花蛋糕、生食海产品）；零售：酒类、预包装食品、卷烟（凭有效许可证经营）。（依法须经批准的项目，经相关部门批准后方可开展经营活动）
佛山市开心娱乐有限公司	一般项目:棋牌室服务;台球活动;信息咨询服务（不含许可类信息咨询服务）;社会经济咨询服务;人力资源服务（不含职业中介活动、劳务派遣服务）;软件开发;信息系统集成服务;平面设计;信息系统运行维护服务;计算机系统服务;信息技术咨询服务;计算机及办公设备维修;计算机软硬件及辅助设备批发;计算机软硬件及辅助设备零售;工业控制计算机及系统销售;计算机及通讯设备租赁;通讯设备销售;通讯设备修理;办公设备销售;办公设备租赁服务;电子产品销售;数字视频监控系统销售;国内贸易代理。（除依法须经批准的项目外,凭营业执照依法自主开展经营活动）许可项目:足浴服务;建筑智能化系统设计;餐饮服务。（依法须经批准的项目,经相关部门批准后方可开展经营活动,具体经营项目以相关部门批准文件或许可证件为准）
佛山市高明区菲尔姆影院有限公司	电影放映;影院投资、管理;食品经营;广告设计制作及发布、会议演出及接待;国内贸易;场地租赁服务。（依法须经批准的项目,经相关部门批准后方可开展经营活动。）（依法须经批准的项目,经相关部门批准后方可开展经营活动）
佛山市唯万健身有限公司	休闲健身活动（健身服务）；体育运动咨询；销售：体育用品。（依法须经批准的项目，经相关部门批准后方可开展经营活动）
佛山市星多多文化传播有限公司	其他未列明商务服务业（文化活动组织策划服务）；文化艺术培训（舞蹈艺术培训教育）（工商登记前置审批项目除外）；企业形象策划服务、其他文化艺术经纪代理、文艺创作与表演、会议及展览服务；广告业；销售：工艺品、办公用品。（依法须经批准的项目，经相关部门批准后方可开展经营活动）
蔻迪（佛山市）餐饮管理有限公司	一般项目:餐饮管理;品牌管理;包装服务;外卖递送服务;娱乐性展览;业务培训（不含教育培训、职业技能培训等需取得许可的培训）;互联网销售（除销售需要许可的商品）;以自有资金从事投资活动;食品销售（仅销售预包装食品）。（除依法须经批准的项目外,凭营业执照依法自主开展经营活动）许可项目:食品销售;酒类经营;餐饮服务。（依法须经批准的项目,经相关部门批准后方可开展经营活动,具体经营项目以相关部门批准文件或许可证件为准）
中视智投文化产业广东有限公司	一般项目:组织文化艺术交流活动;数字文化创意内容应用服务;其他文化艺术经纪代理;文化娱乐经纪人服务;文化场馆管理服务;互联网销售（除销售需要许可的商品）;国内贸易代理;广告发布;数字内容制作服务（不含出版发行）;广告设计、代理;广告制作;企业形象策划;工艺美术品及收藏品零售（象牙及其制品除外）;礼品花卉销售;数字文化创意技术装备销售;汽车新车销售;汽车装饰用品销售;服装服饰零售;服装服饰批发;珠宝首饰零售;珠宝首饰批发;包装服务;会议及展览服务;金属工具销售;家用电器销售;新鲜水果零售;农副产品销售;针纺织品销售;鞋帽零售;箱包销售;日用百货销售;化妆品零售;办公用品销售;计算机软硬件及辅助设备零售;通讯设备销售;家居用品销售;食品销售（仅销售预包装食品）;特种陶瓷制品销售;技术服务、技术开发、技术咨询、技术交流、技术转让、技术推广;玩具、动漫及游艺用品销售;艺（美）术品、收藏品鉴定评估服务;游艺用品及室内游艺器材销售;玩具销售;文具用品零售;工业工程设计服务;社会经济咨询服务;教育咨询服务（不含涉许可审批的教育培训活动）;礼仪服务;以自有资金从事投资活动;文艺创作;组织体育表演活动。（除依法须经批准的项目外,凭营业执照依法自主开展经营活动）
佛山市星尚娱乐有限公司	娱乐场所经营（KTV）;食品经营。（依法须经批准的项目,经相关部门批准后方可开展经营活动。）（依法须经批准的项目,经相关部门批准后方可开展经营活动）
佛山市维康信盈旅游开发有限公司	旅游观光项目开发,酒店项目开发,房地产开发。（依法须经批准的项目,经相关部门批准后方可开展经营活动）
佛山新动力越界思哲影业有限公司	许可项目:电影发行;电视剧发行;食品销售。（依法须经批准的项目,经相关部门批准后方可开展经营活动,具体经营项目以相关部门批准文件或许可证件为准）一般项目:市场营销策划;会议及展览服务;广告设计、代理;广告制作;广告发布;国内贸易代理;非居住房地产租赁;土地使用权租赁。（除依法须经批准的项目外,凭营业执照依法自主开展经营活动）
三水温泉高尔夫球俱乐部	经营温泉浴室、餐厅、会员住所、保龄球、卓球等体育康乐设施。（依法须经批准的项目,经相关部门批准后方可开展经营活动）
佛山崎乐岭文化创意有限公司	文化创意;民宿经营;餐饮服务;商务咨询策划代理;高新技术研发;软件设计;动漫制作;电子商务;网络交易服务;工业设计;股权投资。*（依法须经批准的项目,经相关部门批准后方可开展经营活动）
佛山市八维健身有限公司	健身服务;食品经营。*（依法须经批准的项目,经相关部门批准后方可开展经营活动）
佛山市三水区文翔文化有限公司	提供群众文化活动；场地租赁；组织商品展销、展览；摄影、艺术展览服务；停车场服务；预包装食品、日用品、工艺品零售；设计、制作、发布、代理国内外各类广告；露天游艺、露天游泳池服务（由分支机构经营）。（依法须经批准的项目，经相关部门批准后方可开展经营活动）
佛山市金喜涞健康产业有限公司	一般项目:以自有资金从事投资活动;健康咨询服务（不含诊疗服务）;体育竞赛组织;体育用品及器材零售;文具用品零售;企业管理;非居住房地产租赁;健身休闲活动。（除依法须经批准的项目外,凭营业执照依法自主开展经营活动）许可项目:高危险性体育运动（游泳）;体育场地设施经营（不含高危险性体育运动）;食品经营。（依法须经批准的项目,经相关部门批准后方可开展经营活动,具体经营项目以相关部门批准文件或许可证件为准）
佛山市三水森林赛车俱乐部有限公司	经营赛车俱乐部、青少年卡丁车培训基地、非居住房地产租赁、中餐制售及配套的为赛车会员服务的渡假、游乐、生活等设施。（以上经营项目涉及行政许可的须凭相关许可证经营）（依法须经批准的项目,经相关部门批准后方可开展经营活动。）（依法须经批准的项目,经相关部门批准后方可开展经营活动）
广东森林王国户外文化有限公司	户外拓展活动组织及策划;文化艺术交流策划;旅游景点的建设及经营管理;旅游产品的开发及经营;食品经营;企业管理咨询及培训服务;会议组织及策划;工艺品（不含象牙制品）销售;动物饲养观光活动及其他休闲观光活动。以下项目由属分支机构经营:儿童游乐（不含电子游戏游艺）服务。*（依法须经批准的项目,经相关部门批准后方可开展经营活动）
佛山市型动者健身管理有限公司	一般项目:健身休闲活动;体育健康服务;健康咨询服务（不含诊疗服务）;组织文化艺术交流活动;体育保障组织;体育用品及器材零售;食品销售（仅销售预包装食品）;国内贸易代理。（除依法须经批准的项目外,凭营业执照依法自主开展经营活动）许可项目:高危险性体育运动（游泳）。（依法须经批准的项目,经相关部门批准后方可开展经营活动,具体经营项目以相关部门批准文件或许可证件为准）
佛山市伍迪创意文化传播有限公司	文化和艺术创作传播；大型活动组织策划服务；企业形象策划服务；动漫及衍生产品设计服务；广告业；企业管理咨询服务；影视经纪代理服务；音像经纪代理服务；会议及展览服务；文化娱乐经纪人。（依法须经批准的项目，经相关部门批准后方可开展经营活动）
佛山市三水区恒星娱乐有限公司	卡拉OK、歌舞娱乐服务,餐饮服务,旅客住宿服务,销售:农副产品（不含活禽）、烟、日用百货。*（依法须经批准的项目,经相关部门批准后方可开展经营活动）
佛山市朗盛文化传播有限公司	文化艺术活动组织、策划与咨询;会议及展览服务;设计、制作、代理、发布广告;企业营销策划;企业管理培训咨询服务;教育培训咨询服务（不含出国留学咨询与中介业务）;市场信息咨询服务;企业形象策划;室内装饰工程设计;摄影服务;物业管理和租赁服务;销售:农副产品（不含活禽）、礼品、工艺品、电子产品、计算机及计算机软件。*（依法须经批准的项目,经相关部门批准后方可开展经营活动。）（依法须经批准的项目,经相关部门批准后方可开展经营活动）
佛山市三水世纪皇庭酒店有限公司	酒店管理服务。（依法须经批准的项目,经相关部门批准后方可开展经营活动）
佛山市傲腾酒吧有限公司	许可项目：酒吧服务（不含演艺娱乐活动）；餐饮服务；歌舞娱乐活动；食品销售。（依法须经批准的项目，经相关部门批准后方可开展经营活动，具体经营项目以相关部门批准文件或许可证件为准）
珠江电影集团有限公司	摄制电影片,复制本单位影片,按规定发行国产影片及其复制品;电视剧制作;电影、电视剧和影视节目投资,影视企业投资,电影频道投资和经营;设计、制作、发布、代理国内外各类广告。（依法须经批准的项目,经相关部门批准后方可开展经营活动）
惠州报业传媒集团有限公司	本版报纸批发、零售（以上项目由下属机构凭有效许可证经营）;文化产业项目投资、开发和市场营销策划、市场信息咨询服务、市场调查服务;广告经营;书画艺术品展览、交易;室内装饰工程;计算机技术咨询、技术维护服务、软件开发与销售、网站设计开发与运维;电子商务;互联网信息服务（不含金融）;文化艺术交流策划、商业活动策划、会务服务;商贸服务、展览展示服务;图文设计制作;舆情监测与分析、应对;文化创意产业、旅游服务、经济信息咨询;数据处理（基于大数据、云计算技术的舆情信息采集、挖掘、筛选、分析、加工和传输）;利用互联网经营音乐娱乐产品、艺术品、动漫产品、票务服务（不含象牙制品）;从事互联网文化产品的展览、比赛活动;网络工程;物流代理服务;租赁、物业管理;组织文化艺术交流、策划经营性演出;演出服务;票务服务;预包装食品销售;散装食品销售。（依法须经批准的项目,经相关部门批准后方可开展经营活动）
清远广播电视传媒集团有限责任公司	广播影视节目制作发行,报刊发行,新媒体网站建设,网络广播电视台运营,手机电视运营;媒体广告经营,设计、制作、发布、代理各类广告;组织策划大型活动,文化产业运营;电视商务、绿色农业投资开发、房地产开发经营、旅游项目投资开发;产品包装、销售代理;互联网销售（除销售需要许可的商品）;水产品零售;新鲜水果零售;新鲜蔬菜零售;电子产品销售;家用电器销售;照相机及器材销售;体育用品及器材零售;玩具销售;服装服饰零售;鞋帽零售;针纺织品销售;皮革制品销售;日用品销售;日用杂品销售;母婴用品销售;化妆品零售;文具用品零售;食品销售;体育保障组织;组织体育表演活动。（依法须经批准的项目,经相关部门批准后方可开展经营活动）
家庭期刊集团有限公司	出版、发行《家庭》、《孩子》、《赢未来》、《尚流》、《财讯》、《当代家庭教育》杂志及其数字化作品；设计和制作印刷品广告，利用上述出版物发布国内外广告；网络游戏出版；新媒体平台运营；网络技术开发服务；系统内业务轮训的组织策划、咨询服务；文化活动组织策划、市场营销、商品展览、咨询服务；销售：纸、纸制品；家政服务业（不含劳务派遣）；房产出租及物业管理；实业投资。（依法须经批准的项目，经相关部门批准后方可开展经营活动）
广东祺商建设集团有限公司	工业、民用建筑、桥梁、道路的施工;建设项目的投资、策划、管理及相关信息的咨询;工程排水施工服务;消防设备工程设计与施工;机电设备安装服务;建筑物电力系统安装;河湖治理及防洪设施工程建筑;输水管道工程施工服务;园林绿化工程服务;架线工程服务;电力输送设施安装工程服务;通信设施安装工程服务;广告的设计、制作、发布、代理;（依法须经批准的项目,经相关部门批准后方可开展经营活动）
广东晋明集团有限公司	人力资源外包，劳务承揽；投资管理（不含期货、证券），房地产中介咨询，项目投资可行性研究，企业管理咨询，商品信息咨询；销售：建材、五金交电、机械设备、日用百货；书画展览策划，商品展览策划，企业文化活动策划；室内装饰设计；设计、制作、代理、发布国内外各类广告；物业管理；场地出租。（依法须经批准的项目，经相关部门批准后方可开展经营活动）
广东荣艺会文化电商实业集团有限公司	企业文化策划,书画装裱,展示展览,生物科技领域内的技术开发;农业技术研发,特色旅游开发;批发、零售及网上销售:工艺品、书画、乐器、日用品、艺术品;设计、制作、发布、代理国内外各类广告;艺术品展览服务;礼仪服务;公关活动策划、企业形象策划、文化艺术交流活动策划;物业租赁,室内装饰工程;销售加工农副产品。
广东葫芦堡文化科技股份有限公司	文艺创作;动漫设计与制作;文化创意工程策划;文化科技主题公园设计;研发、生产、销售:智能家居产品,智能婴幼儿用品,智能学习用品,智能机器人,智能控制系统,数码电子产品;设计、生产、销售:母婴用品,童车,玩具、家具、家居用品,塑料制品,五金制品;销售:日用品,服装;货物进出口;网上销售:家居用品、母婴用品;虚拟现实及增强现实技术开发、技术转让。（依法须经批准的项目,经相关部门批准后方可开展经营活动）
广州注意力数字新媒体股份有限公司	文化场馆管理服务;文艺创作;文具制造;企业管理咨询;企业形象策划;包装服务;图文设计制作;广告发布（非广播电台、电视台、报刊出版单位）;广告制作;品牌管理;企业信用管理咨询服务;礼仪服务;企业管理;信息咨询服务（不含许可类信息咨询服务）;市场营销策划;广告设计、代理;人力资源服务（不含职业中介活动、劳务派遣服务）;影视美术道具置景服务;其他文化艺术经纪代理;娱乐性展览;组织体育表演活动;休闲观光活动;公园、景区小型设施娱乐活动;组织文化艺术交流活动;项目策划与公关服务;工艺美术品及礼仪用品制造（象牙及其制品除外）;纸制品销售;工艺美术品及收藏品零售（象牙及其制品除外）;办公服务;五金产品零售;激光打标加工;文具制造;休闲娱乐用品设备出租;办公设备租赁服务;喷涂加工;电镀加工;木材加工;人造板制造;光电子器件制造;塑料制品制造;合成纤维制造;五金产品批发;人造板销售;合成纤维销售;塑料制品销售;人造板销售;合成纤维销售;光电子器件销售;玻璃纤维及制品销售;照明器具销售;交通及公共管理用金属标牌制造;交通及公共管理用标牌销售;照明器具销售;照明器具制造;玻璃纤维及制品制造;包装装潢印刷品印刷;印刷品装订服务;文件、资料等其他印刷品印刷
深圳市大与文体度假中心有限公司	一般经营项目是:投资经营体育项目（不含高危险性体育项目）;体育用品、健身器材的技术开发与购销;体育项目培训及相关信息咨询;会议策划;汽车配件销售;房屋租赁;物业管理。体育场馆的经营和管理;体育比赛经纪代理;健身健美馆的经营与管理;茶具的购销。,许可经营项目是:酒店经营;提供茶艺棋牌服务;餐饮服务;茶叶的购销。
深圳市宝携投资有限公司	一般经营项目是:股权投资;投资管理;投资咨询;企业管理咨询;自有房屋租赁;会议及展览策划;提供清洁服务;商业项目、零售商业企业项目的策划;企业管理咨询;工艺品、首饰、珠宝的技术研发、技术服务、技术信息咨询;镶嵌首饰、琥珀首饰、工艺美术品的设计、批发;国内贸易;经济信息咨询;经营进出口业务,限制的项目须取得许可后方可经营);,许可经营项目是:物业管理,
融创（深圳）文化旅游运营管理有限公司	一般经营项目是:以自有资金对旅游业、文化业、影视业、房地产业、商业海洋馆、水族馆、动物园、游乐园进行投资;旅游管理服务,商务信息咨询,酒店管理,企业管理咨询（投资及资产管理除外）,企业营销策划;大型活动组织服务;组织文化艺术交流活动;旅游资源开发;文艺创作;展览展示服务;舞台设计;工艺美术品设计（不含象牙及其制品）:设计、制作、代理、发布广告;旅游技术开发、旅游景区管理、计算机软硬件的技术开发、技术服务、技术咨询、技术转让、技术推广;网络游戏研发、应用;票务服务;婚庆礼仪服务;酒店管理服务;企业管理服务（投资及资产管理除外）:会议服务;物业服务;文化艺术交流活动策划;动漫设计;计算机图文设计;房屋租赁;机器设备租赁;车辆租赁（不包括网约车、不包括带操作人员的汽车出租）;场地租赁;文化用品、日用百货、针纺织品、服装鞋帽、文教用品、五金交电、通讯设备、电子设备、计算机及外围设备、体育用品（弩除外）、旅游纪念品、玩具、农副产品批发兼零售;货物进出口、技术进出口（国家限定禁止经营的商品及技术除外）;体育场馆服务;（一般经营项目自主经营,许可经营项目凭相关许可证或者批准文件经营）（依法须经批准的项目,经相关部门批准后方可开展经营活动。）,许可经营项目是:城市停车场服务;游乐园设备安装、维修及保养;文化娱乐经纪代理;演出经纪服务;组织经营性演出;电影放映;旅行社业务经营;住宿服务;餐饮服务、食品生产经营。
深圳市容德文化科技集团有限公司	一般经营项目是:从事文化交流、文化传播;文艺创作、音乐创作;音乐剧创作、舞台剧创作,从事广告业务（法律、行政法规规定应进行广告经营审批登记的,另行办理登记后方可经营）;企业形象策划、文化活动策划、演出活动策划;文化用品、工艺美术品贸易;影视剧本创作、策划;影视版权、文化知识产权咨询及代理（不含专利代理）;影视衍生产品的开发设计、推广;住房租赁;非居住房地产租赁;自有房地产经营活动。（除依法须经批准的项目外,凭营业执照依法自主开展经营活动）;技术服务、技术开发、技术咨询、技术交流、技术转让、技术推广。（除依法须经批准的项目外,凭营业执照依法自主开展经营活动）;酒店管理;文化场馆管理服务;数字文化创意内容应用服务;会议及展览服务;社会人文科学研究;珠宝首饰零售;珠宝首饰批发;金银制品销售;工艺美术品及礼仪用品销售（象牙及其制品除外）;工艺美术品及收藏品零售（象牙及其制品除外）;工艺美术品及收藏品批发（象牙及其制品除外）;互联网销售（除销售需要许可的商品）;汽车新车销售;新能源汽车整车销售;汽车零部件研发;组织文化艺术交流活动;其他文化艺术经纪代理;互联网数据服务。（除依法须经批准的项目外,凭营业执照依法自主开展经营活动）,许可经营项目是:从事艺人经纪业务、演出经纪业务;电影摄制、影视策划;微电影、网络剧制作与发行;房地产经纪。（依法须经批准的项目,经相关部门批准后方可开展经营活动,具体经营项目以相关部门批准文件或许可证件为准）;食品互联网销售（仅销售预包装食品）。（依法须经批准的项目,经相关部门批准后方可开展经营活动,具体经营项目以相关部门批准文件或许可证件为准）
万达体育有限公司	广播电视节目制作（具体经营范围以《广播电视节目制作经营许可证》为准）;赛事转播服务;游泳馆;体育项目投资与管理;体育赛事运营（涉及许可项目的,需取得许可后方可经营）;体育营销策划服务;体育运动咨询服务;体育经纪人;运动场馆服务（游泳馆除外）;体育培训;体育组织;竞技体育科技服务;服装批发;服装零售;体育用品及器材批发;体育用品及器材零售;体育设备、器材出租;体育器材装备安装服务
深圳前海蔚蓝网络文化传媒有限公司	一般经营项目是:影视文化项目的开发,影视文化项目投资、文化产业项目投资;从事广告业务;文化交流活动策划;计算机软硬件的技术开发与销售;互联网信息技术开发、技术服务;电脑图文设计、美术设计;商务信息咨询、财务信息咨询、市场营销策划,展览展示策划、企业形象设计;市场信息咨询;礼仪策划;会务策划、公关活动策划、文体活动策划;翻译;自有物业租赁;健康养生管理咨询（不含医疗行为）;文具、文化用品的销售。（以上法律、行政法规、国务院决定禁止的项目除外,限制的项目须取得许可后方可经营）。,许可经营项目是:影视节目的拍摄与制作,承办文化体育活动,国内国外影视发行;举办大型文艺活动及演出,国际文化传媒;开展者视频专业技术培训;为演艺人员提供培训服务及经纪业务;教育信息咨询;人力资源管理咨询;人力资源信息咨询;人才信息咨询;模特演出经纪;物业管理。
全购供应链管理股份有限公司	一般经营项目是:供应链管理服务;第一类医疗器械销售;广告设计、代理;广告发布（非广播电台、电视台、报刊出版单位）;广告制作;国内集装箱货物运输代理;信息咨询服务（不含许可类信息咨询服务）;工业互联网数据服务;互联网销售（除销售需要许可的商品）;国内贸易代理;贸易代理;日用百货销售;普通货物仓储服务（不含危险化学品等需许可审批的项目）;包装服务;日用品批发;日用品销售;企业管理;企业管理咨询;软件开发;软件销售;计算机系统服务;业务培训（不含教育培训、职业技能培训等需取得许可的培训）。（除依法须经批准的项目外,凭营业执照依法自主开展经营活动）,许可经营项目是:第二类医疗器械销售;国际货物运输代理;进出口代理;食品互联网销售（仅销售预包装食品）;食品销售（仅销售预包装食品）;食品销售;物业管理。（依法须经批准的项目,经相关部门批准后方可开展经营活动,具体经营项目以相关部门批准文件或许可证件为准）
深圳市前海经典文化应用有限公司	一般经营项目是:文化活动策划;企业形象策划;投资兴办实业（具体项目另行申报）;投资教育产业项目（具体项目另行申报）;企业管理咨询、投资咨询、经济信息咨询（以上均不含限制项目）;教育信息咨询（不含证券咨询、人才中介服务和其他限制项目）;股权投资。（以上各项涉及法律、行政法规、国务院决定禁止的项目除外,限制的项目须取得许可后方可经营）,许可经营项目是:教育培训。
中联影视文化传媒股份有限公司	电影摄制服务;摄像及视频制作服务;文艺创作;市场营销策划;广告设计、代理;广告发布（非广播电台、电视台、报刊出版单位）;广告制作;组织文化艺术交流活动;婚庆礼仪服务;企业形象策划;项目策划与公关服务;平面设计;专业设计服务;文化用品设备出租;咨询策划服务;会议及展览服务;工艺美术品及收藏品批发（象牙及其制品除外）;工艺美术品及礼仪用品销售（象牙及其制品除外）;工艺美术品及收藏品零售（象牙及其制品除外）;电子产品销售;国内贸易代理;广播电视视频点播业务;电影放映;电影发行;演出经纪;营业性演出;住宅室内装饰装修
深圳太鸿实业集团有限公司	一般经营项目是:投资兴办实业、旅游项目投资、健康产业项目投资、农业项目投资、林业项目投资、牧业项目投资（具体项目另行申报）;文化艺术活动策划;摄影摄像服务;从事广告业务;信息技术开发;图文设计;品牌营销策划;市场营销策划;园林绿化景观设计;旅游纪念品的设计及销售;为餐饮企业、酒店提供管理服务;国内贸易;货物及技术进出口;矿产品、煤炭、建材、化工产品（不含危险品）、金属材料、汽车配件、一二类医疗器械、计算机软硬件、五金交电、家用电器、钢材的销售;物业管理;健康养生管理咨询;农业、林业、牧业的技术服务;园林绿化。（法律、行政法规、国务院决定禁止的项目除外,限制的项目须取得许可后方可经营）,许可经营项目是:国内旅游业务、境内旅游业务、境外旅游业务,对体检中心进行管理;养老服务;养生文化交流活动策划与推广;健康养生项目开发;农产品、林产品初加工服务;森林经营和管护;森林改培。
中民健康产业（深圳）有限公司	一般经营项目是:健康养生服务（不含医疗）;旅游景区运营管理;文化产业开发、经营;文化旅游产品的开发、经营;文化旅游项目投资、策划、运营管理;;养生养老产业投资;个体或群体健康的检测、分析、评估以及健康咨询（不含医疗）;健康产业投资;经营进出口业务（不含专营、专控、专卖商品）市场调查（不含涉外调查）;企业策划服务;组织文化艺术交流活动。,许可经营项目是:室内外装饰工程施工;建筑施工;市政工程施工。
深圳中安康华健康管理有限公司	一般经营项目是:干细胞系列技术工程产品的产业化开发;单克隆抗体诊疗技术研究、开发应用及抗肿瘤新药产业化的技术研究;血液病及其他恶性疾病诊疗技术、细胞抗体、基因药物的技术、开发及研究;货物及技术的进出口业务;自有房产租赁;物业管理;健康信息咨询（不含医疗行为）;心理咨询（不含医学心理咨询、医学心理训练、医学心理辅导等医疗行为）;营养方案及运动方案咨询;投资兴办医疗机构（具体项目另行申报）;为医疗机构提供行政事务管理服务（不含医疗行为）;生物制品的技术开发;生物科技产品的技术开发;医疗软件的设计与开发并提供相应的技术咨询;第一类医疗器械、仪器仪表、办公设备的销售;国内贸易（不含专营、专卖、专控商品）;经营进出口业务（法律、行政法规或者国务院决定禁止和规定在登记前须经批准的项目除外）。（依法须经批准的项目,经相关部门批准后方可开展经营活动）,许可经营项目是:干细胞工程系列产品的技术开发及研制销售;体外诊断试剂制造（以医疗器械生产企业许可证为准）;细胞相关产品销售（药品除外,限分支机构经营）;脐带血干细胞及其它组织干细胞的储存及提供技术服务。
广东教育出版社有限公司	编辑、出版学校和业余教育的教材、教辅材料、教学参考书,教育科学理论学术著作、期刊、电子读物,与已获许可出版内容范围相一致的网络（含手机网络）出版业务;配合本版图书出版音像制品;代理出版图书业务,设计和制作印刷品广告,利用自有书籍、《课程教学研究》发布广告;本版图书、电子出版物、音像制品及期刊《课程教学研究》的发行;计算机软件、教育信息系统的开发、集成、销售及维护;教学设备的研究开发、销售;教育装备产品、玩具的研发、生产及销售;通过互联网及实体店销售:计算机、软件及辅助设备,文化用品、体育用品及器材,家具,纸、纸制品,印刷用纸;开展相关学科的教育咨询和培训;自有资金投资;教育项目开发;文化创意、咨询服务;场地、房屋租赁;物业管理。
广州开发区金寓人才服务集团有限公司	企业管理;企业总部管理;单位后勤管理服务;酒店管理;餐饮管理;会议及展览服务;园区管理服务;非居住房地产租赁;物业管理;体育用品及器材零售;文物文化遗址保护服务;非物质文化遗产保护;旅游业务;体育场地设施经营（不含高危险性体育运动）;餐饮服务;小餐饮;危险废物经营;食品经营;住宿服务
广东昭阳和牧场文化传播集团有限公司	文艺创作;广告设计、代理;广告制作;广告发布（非广播电台、电视台、报刊出版单位）;市场调查（不含涉外调查）;市场营销策划;信息咨询服务（不含许可类信息咨询服务）;信息技术咨询服务;组织文化艺术交流活动;休闲观光活动;组织体育表演活动;体验式拓展活动及策划;电影摄制服务;其他文化艺术经纪代理;文化娱乐经纪人服务;幻灯及投影设备销售;机械设备租赁;计算机及通讯设备租赁;办公设备租赁服务;广播影视设备销售;计算机及办公设备维修;办公设备销售;广播电视设备专业修理;互联网设备销售;电子专用设备销售;办公设备耗材销售;文化用品设备出租;计算机软硬件及辅助设备零售;通信设备销售;数字视频监控系统销售;照相器材及望远镜零售;照相器材及望远镜批发;照相机及器材销售;工程和技术研究和试验发展;平面设计;专业设计服务;工业设计服务;教育咨询服务（不含涉许可审批的教育培训活动）;咨询策划服务;技术服务、技术开发、技术咨询、技术交流、技术转让、技术推广;租借道具活动;影视美术道具置景服务;摄像及视频制作服务;信息网络传播视听节目;游艺娱乐活动;电影放映;电影发行;建设工程设计;广播电视节目制作经营;音像制品制作;货物进出口;技术进出口
惠州狮子城文化有限公司	娱乐场所经营;公共场所经营;餐饮服务;技术开发、咨询、转让及推广;企业文化策划;市场调查服务;设计、制作、代理、发布广告;承办展览展示活动;房屋租赁;物业管理;票务代理;营业性演出;水产养殖;旅游用品批发与零售;旅行社经营;旅游信息咨询服务;销售、日用百货、酒;酒店管理;住宿服务;卷烟零售。
天寅影业（深圳）有限公司	一般经营项目是:国内贸易;经营进出口业务,限制的项目须取得许可证后方可经营);投资兴办实业(具体项目另行申报);企业管理咨询;文化艺术品、玉石珠宝销售;从事广告业务;会展策划;为企业提供孵化服务。,许可经营项目是:电影电视剧、游戏动漫的制作、摄制、复制、发行(凭经营许可证在核定期限内经营)。
深圳观澜湖体育实业股份有限公司	一般经营项目是:在规划区域内从事体育场馆及其配套设施的建设、开发和经营;高尔夫球练习场、网球场及其配套的会所、餐厅、附属商店、健身室和其他体育项目的建设和经营;经营桌球室、壁球室、棋艺室、保龄球室、真雪溜冰场、旱冰场、电动微型汽车场、碰碰车场、人工水上活动场、儿童电动游艺中心、图书室、博览室、器械健身室、卡拉OK、美容、美发、骑术中心、体育培训、体育娱乐项目、体育康复保健项目;协办或经批准承办体育比赛;体育用品的开发、生产和经营;体育项目委托管理和经营;体育信息咨询;体育主题社区建设。增营:从事位于宝安区观澜街道高尔夫球场观澜高尔夫球场一栋一层、二层、三层,观澜镇高尔夫大道南侧观澜高尔夫球场二栋一层、二层、三层的自有物业租赁。展览展示策划、雕塑品制作、文化艺术类活动策划、体育活动策划、旅游活动策划。(以上项目不涉及外商投资准入特别管理措施),许可经营项目是:机动车停放服务。
广州烈公集团有限公司	信息咨询服务（不含许可类信息咨询服务）;广告发布（非广播电台、电视台、报刊出版单位）;文艺创作;住房租赁;非居住房地产租赁;摄像及视频制作服务;广告制作;互联网销售（除销售需要许可的商品）;专业设计服务;广告设计、代理;平面设计;数字内容制作服务（不含出版发行）;出版物零售;出版物批发;出版物互联网销售
广东南方光原文化有限公司	艺（美）术创作服务;群众参与的文艺类演出、比赛等公益性文化活动的策划;广告业;贸易咨询服务;企业管理咨询服务;企业形象策划服务;市场调研服务;日用杂品综合零售;大型活动组织策划服务（大型活动指晚会、运动会、庆典、艺术和模特大赛、艺术节、电影节及公益演出、展览等,需专项审批的活动应在取得审批后方可经营）;文艺创作服务;体育经纪人;文化娱乐经纪人;包装装潢设计服务;展台设计服务;美术图案设计服务;多媒体设计服务;工业设计服务;时装设计服务;动漫及衍生产品设计服务;饰物装饰设计服务;标识、标志牌设计、安装服务;文化艺术咨询服务;公共关系服务;策划创意服务;市场营销策划服务;物业管理;房地产中介服务;艺术表演场馆管理服务;运动场馆服务（游泳馆除外）;体育营销策划服务;体育项目投资与管理;体育赛事运营（涉及许可项目的,需取得许可后方可经营）;体育组织;竞技体育科技服务;游戏软件设计制作;投资咨询服务;文化产业园的投资、招商、开发、建设;新媒体产业园的投资、招商、开发、建设;商品批发贸易（许可审批类商品除外）;商品零售贸易（许可审批类商品除外）;会议及展览服务;城市规划设计;城乡规划编制;房地产开发经营;工程项目管理服务;工程建设项目招标代理服务;旅游景区规划设计、开发、管理;教育咨询服务;教育评估;自费出国留学中介服务;为留学人员提供创业、投资项目的信息咨询服务;文化研究;文化推广（不含许可经营项目）;文化传播（不含许可经营项目）;舞台表演艺术指导服务;信息技术咨询服务;计算机技术开发、技术服务;软件技术推广服务;计算机技术转让服务;歌舞厅娱乐活动;网络游戏服务;电影和影视节目发行;营业性文艺表演;展览馆;美术馆;电影和影视节目制作;广播电视节目制作（具体经营范围以《广播电视节目制作经营许可证》为准）
深圳华侨城文化集团有限公司	一般经营项目是:文化产业园区策划、开发和运营;文化内容产业投资和运营（具体项目另行申报）。茶叶种植;茶具销售;包装服务;家具销售;会议及展览服务;电子产品销售;工艺美术品及收藏品零售（象牙及其制品除外）;专业设计服务;数字文化创意内容应用服务;数字文化创意软件开发;组织文化艺术交流活动;文艺创作;体育保障组织;商业综合体管理服务;非居住房地产租赁;广告设计、代理;图文设计制作;平面设计;广告制作;摄像及视频制作服务;市场营销策划;体育赛事策划;体验式拓展活动及策划;组织体育表演活动;自有房地产经营活动;食用农产品初加工;仓储服务;停车场服务;农副产品销售;互联网销售（除销售需要许可的商品）;花卉种植;农产品的生产、销售、加工、运输、贮藏及其他相关服务;咨询策划服务;酒店管理;针纺织品销售;玩具、动漫及游艺用品销售;游艺及娱乐用品销售;服装服饰出租;鞋帽零售;文具用品零售。（除依法须经批准的项目外,凭营业执照依法自主开展经营活动）,许可经营项目是:公共文化演艺策划和运营;亲子文化观光农场、少儿文化艺术教育投资和运营;广播电视节目制作、影视广告制作、动漫制作及技术开发与销售;出版物批发、零售。食品经营销售;烟草制品零售;酒类经营;食品、饮料零售（除烟草制品零售）;餐饮服务;住宿服务;营业性演出;物业管理。（依法须经批准的项目,经相关部门批准后方可开展经营活动,具体经营项目以相关部门批准文件或许可证件为准）
深圳非凡好声音影视集团有限公司	一般经营项目是:网络营销策划;文艺创作;文化活动策划;电商运营;网红包装与推广;网络技术服务;教育培训（不含学历教育、学科类培训及职业技能培训）;文化艺术交流活动策划（不含营业性演出）;互联网文化活动策划;对文化、体育和娱乐业的投资;信息技术咨询服务;数字出版领域内的技术开发、技术转让、技术咨询、技术服务;信息技术服务;从事广告业务;电子产品、电子元器件、无线充电器、数据线、手机壳、手机套、蓝牙设备、耳机、音箱、灯具、手机防水袋的技术开发及销售;国内贸易;经营进出口业务;商务信息咨询;企业管理咨询;物联网及人工智能技术产品技术开发、销售;展览展示活动策划;教育咨询（不含学科类培训）;经济贸易咨询;电脑图文设计、制作;企业形象策划;文化用品、体育用品、首饰、工艺品（象牙及其制品除外） 、玩具、游艺用品、室内游艺器材、乐器、照相器材、计算机、软件及辅助设备的销售;翻译服务;从事电子商务;舞蹈培训（不含职业技能培训）;乐器培训与销售;瑜伽培训;唱歌培训;经营棋牌室;花卉租赁;园艺苗木、种植肥料、花卉盆景、鲜花的销售;建筑材料的销售;水电水利工程、建筑装饰工程、消防安装工程、室内装修、安防工程的施工。（法律、行政法规、国务院决定禁止的项目除外,限制的项目须取得许可后方可经营）,许可经营项目是:网络直播;视频拍摄与制作;影视制作;广播电视节目制作;互联网信息服务;预包装食品销售;散装食品销售;中餐制售;提供茶水服务;园林绿化工程的设计、施工及养护;园林道路维护、设计与施工;建筑劳务分包。
深圳市注艺产业有限公司	一般经营项目是:房地产开发;酒店管理服务;物业租赁;物业管理;企业管理咨询;餐饮管理;场地租赁服务;从事房地产经纪;商业地产投资及经营;数字电影技术开发与技术服务;电影后期制作技术开发与技术服务;摄影、摄像服务;影视服装道具及器材租赁;摄影棚管理和租赁;电影置景;电影及舞台美工;租赁灯光音响设备;技术开发、技术咨询、技术服务、技术转让;项目策划;组织文化艺术交流活动（演出除外）;文艺创作;影视策划;企业策划;承办展览展示活动;商业管理咨询;信息咨询。（法律、行政法规、国务院决定禁止的项目除外,限制的项目须取得许可后方可经营）,许可经营项目是:文化经纪业务;电影院经营。
广东省广影业股份有限公司	广告发布（非广播电台、电视台、报刊出版单位）;广告制作;广告设计、代理;电影摄制服务;摄像及视频制作服务;图文设计制作;会议及展览服务;文化娱乐经纪人服务;组织体育表演活动;组织文化艺术交流活动;其他文化艺术经纪代理;市场营销策划;票务代理服务;平面设计;专业设计服务;数字内容制作服务（不含出版发行）;企业形象策划;项目策划与公关服务;咨询策划服务;社会经济咨询服务;信息咨询服务（不含许可类信息咨询服务）;非居住房地产租赁;礼仪服务;广播电视节目制作经营;电视剧制作;音像制品制作;演出经纪
广东有线广播电视网络有限公司	广东省行政区域内有线广播电视网络建设、升级改造、经营、维护和运营管理;广播电视传输业务、扩展业务;因特网接入服务业务、呼叫中心业务、信息服务业务（仅限互联网信息服务,具体按本公司有效证书经营）及其它相关业务;电视传播、电子信息网络技术开发转让和咨询服务;销售有线电视专用配套产品、电子信息网专用配套产品;各类传输网络基础设施投资建设经营、光纤线路出租经营业务;制作、复制、发行:广播剧,电视剧、动画片（制作须另申报）,专题、专栏（不含时政新闻类）,综艺（具体按本公司有效证书经营）;设计、制作、代理、发布国内外广告业务;家用电器产品的代理、销售:经营电子商务;网上批发及零售:工艺美术品,皮革制品,服装鞋帽,玩具,钟表,眼镜及配件,文教用品,照相器材,体育用品,家具,电子产品,电脑及配件,汽车及摩托车配件,宠物用品,金、银饰品,化妆品,厨房、卫生间用品及日用杂货,针纺织品,日用百货,橡胶制品,玻璃仪器,包装材料,音响设备,瓷制品,瓷砖,珠宝玉器,汽车保洁用品,电梯配件,床上用品;计算机软、硬件技术服务,计算机系统集成,计算机网络技术服务;代理电子充值,代售充值卡;票务代理,代订酒店客房、车船票、飞机票、景点门票;境内旅游业务;粮食土特产批发和零售,酒类、预包装食品销售;销售:清洁用品,陶瓷、玻璃器皿,灯具、装饰物品,箱、包,婴儿用品,家居饰品,游艺及娱乐用品,计算机及计算机零配件,通讯设备及配套设备,通讯终端设备,电子产品,蔬菜,水果,冰鲜产品,水产品,餐饮代金券,礼品卡;教育信息咨询及相关培训咨询、商业咨询;美容、美甲、理发服务,护理服务（不涉及提供住宿、医疗诊断、治疗及康复服务）,洗衣服务,防虫灭鼠服务,生活清洗、消毒服务,宠物美容服务（不含寄养、销售）、第二类医疗器械销售、单位后勤管理服务、外卖递送服务、普通货物仓储服务（不含危险化学品等需许可审批项目）。（依法须经批准的项目,经相关部门批准后方可开展经营活动）
广东省洪安集团有限公司	营业性文艺表演,文艺创作服务,群众参与的文艺类演出、比赛等公益性,文化活动策划,红色文化推广、传播,大型活动组织策划服务,房地产开发经营,自有房地产经营活动,房地产估价,房地产咨询服务,建筑物采暖系统安装服务,建筑物空调设备、通风设备系统安装服务,机电设备安装服务,建筑钢结构、预制构件工程安装服务,城市及通路照明工程,园林绿化工程,智能化工程,消防工程,土石方工程,建筑工程后期装饰、装修和清理,室内装饰、装修,计算机软件的研究、开发、销售和相关的技术服务,计算机网络、信息系统的设计、开发、集成和技术服务,电子网络产品的研究、开发;自营和代理各类商品和技术的进出口,但国家限定公司经营或禁止进出口的商品和技术除外。销售:电子网络化设备,IC卡,电子计算机,机动车配件（不含发动机）,服装,日用百货,五金、交电,建筑材料,机电设备（不含小轿车）,电器材料,普通设备,金属材料,粮食,食用油,预包装食品、烟、酒、冷冻食品、雪糕、棉花;商贸信息咨询;安全技术防范系统设计、施工、维修（凭本公司有效资格证书经营）。农业项目开发;农业科学研究及试验;现代农业园区规划及温室设计;农业工程、规划设计、技术推广及开发服务;营养健康、健康管理咨询服务;房地产中介服务;房地产投资;房屋建筑工程施工;建筑工程机械与设备租赁;建筑工程、土木工程技术服务。（依法须经批准的项目,经相关部门批准后方可开展经营活动）
北影控股集团有限公司	一般经营项目是:孵化影视文化企业;影视产业新技术的研发与推广;影视基地的建设与管理;电影院线的建设与管理;影视剧的策划,工艺美术品的销售,国内贸易,国际贸易,五金建材批发,食品农产品日用品销售,企业管理咨询。,许可经营项目是:高端影视人才的培训;影视艺术教育;影视创作;影视拍摄;影视动漫制作;影视后期制作;大型商业综合体和现代生态农业的投资（具体项目另行申报）;影视剧的策划、拍摄、制作与发行;组织和举办大型文化艺术交流活动和大型文艺演出活动。
上海文化广播影视集团有限公司	广播、电视节目的制作、发行及衍生品开发、销售,各类广告的设计、制作、代理、发布,广播电视领域内的技术服务,广播电视设备租赁、经营,承办大型活动、舞美制作、会议会展服务,网络传输,网站运营,现场演艺,演艺经纪,电子商务（不得从事增值电信、金融业务）,投资管理,文化用品批发零售,货物及技术的进出口业务。【依法须经批准的项目,经相关部门批准后方可开展经营活动】
上海东方娱乐传媒集团有限公司	广播电视节目制作、发行；经营演出及经纪业务，设计、制作、代理、发布各类广告，利用自有媒体发布广告，大型活动组织服务，舞美制作，会议会展服务，电子商务，数据集成，企业营销、形象策划，商务咨询，贸易经纪与代理（除拍卖），投资管理，文化用品，工艺礼品销售。【依法须经批准的项目，经相关部门批准后方可开展经营活动】
上海刚泰文化集团有限公司	工艺美术用品的制作及销售,图书报刊零售、出租,文化艺术交流与策划,商务信息及投资咨询（除经纪）,展览展示服务,广告设计与制作,实业投资,物业管理。【依法须经批准的项目,经相关部门批准后方可开展经营活动】
上海中传国际文化产业集团有限公司	文化艺术交流策划（除经纪），文化产业投资，动漫设计，会务会展服务，商务咨询（除经纪），工艺礼品设计、销售。【依法须经批准的项目，经相关部门批准后方可开展经营活动】
上海新文化传媒集团股份有限公司	电视节目制作、发行,电影制片,电影发行,设计、制作、代理、发布各类广告,多媒体科技、计算机网络科技、从事计算机信息科技领域内的技术开发、技术转让、技术咨询、技术服务,经营演出及经纪业务,文化艺术交流策划,文化用品的销售,投资管理。【依法须经批准的项目,经相关部门批准后方可开展经营活动】
上海丝芭文化传媒集团有限公司	许可项目:营业性演出;演出经纪;广播电视节目制作经营;第二类增值电信业务;出版物零售;餐饮服务;拍卖业务。（依法须经批准的项目,经相关部门批准后方可开展经营活动,具体经营项目以相关部门批准文件或许可证件为准）一般项目:礼仪服务;会议及展览服务;企业形象策划;广告设计、代理;广告制作;广告发布;组织文化艺术交流活动;技术服务、技术开发、技术咨询、技术交流、技术转让、技术推广;数据处理和存储支持服务;艺术品代理;互联网销售（除销售需要许可的商品）;日用百货销售;化妆品批发;化妆品零售。（除依法须经批准的项目外,凭营业执照依法自主开展经营活动）
上海景鹄集团有限公司	组织文化艺术交流活动,企业营销策划,文艺创作,广告设计制作,会议及展览服务,摄影服务,企业管理咨询,电脑图文设计制作,计算机系统集成,软件开发,日用百货,文化办公用品、酒店用品、工艺品（象牙及其制品除外）、建筑装潢材料的销售。【依法须经批准的项目,经相关部门批准后方可开展经营活动】
上海万达文化产业集团有限公司	一般项目:文化艺术交流活动策划,投资管理,投资咨询,企业管理咨询,贸易经纪与代理。（除依法须经批准的项目外,凭营业执照依法自主开展经营活动）
上海坚正影视传媒集团有限公司	文化艺术交流活动策划,广播电视节目制作,演出经纪,影视策划与咨询,大型活动组织与策划,公关活动策划,法律信息咨询,建筑工程咨询,建筑设计咨询,工程项目管理咨询,房地产咨询,商务咨询,礼仪服务,展览展示服务,摄影服务,市场营销策划,企业形象策划,舞台灯光设计,仓储服务,景观设计,设计、制作各类广告,电脑图文设计、制作,摄影摄像设备的租赁,婚庆礼仪服务,电子科技、计算机信息科技、机械科技领域内的技术开发、技术转让、技术咨询、技术服务,电子产品、针纺织品、化妆品、玩具、工艺礼品、办公设备、计算机及配件、通讯器材、体育用品的销售,从事货物及技术的进出口业务, 。【依法须经批准的项目,经相关部门批准后方可开展经营活动】
上海聚脉文化传播股份有限公司	广播电视节目制作,设计、制作、代理、发布各类广告,文化艺术活动策划,企业形象策划,会务会展服务,知识产权代理（除专利代理）,商务信息咨询,计算机软件开发、计算机系统集成服务,音响设备销售。【依法须经批准的项目,经相关部门批准后方可开展经营活动】
上海鑫岳影视传播有限公司	电影发行,广播电视节目制作、发行,影视文化艺术活动交流与策划,影视文化、数码、网络信息领域内的技术开发、技术服务、技术咨询、技术转让,摄影摄像,企业形象策划,礼仪服务,会展服务,商务信息咨询（除经纪）,市场营销策划,影视服装、器材、道具租赁,电脑图文设计、制作。【依法须经批准的项目,经相关部门批准后方可开展经营活动】
上海浩祯文化发展股份有限公司	文化艺术交流活动策划，市场营销策划，企业形象策划，餐饮企业管理，企业管理咨询，商务信息咨询，会务服务，音响设备、计算机软硬件及辅助设备的销售，计算机系统集成，食品流通 。【依法须经批准的项目，经相关部门批准后方可开展经营活动】
上海皆悦文化影视传媒股份有限公司	广播电视节目制作、发行,动漫广播电视节目制作、发行,动漫设计,计算机、网络信息、电子领域内的技术开发、技术转让、技术咨询、技术服务,电脑图文设计制作,企业管理咨询,商务咨询,设计、制作、代理、发布各类广告,从事货物进出口及技术进出口业务,销售电子产品,服装,文教用品,针纺织品,化妆品,玩具,工艺品,计算机、软件及辅助设备批发（除计算机信息系统安全专用产品）。【依法须经批准的项目,经相关部门批准后方可开展经营活动】
上海世像文化传媒（集团）有限公司	广播电视节目制作,电子商务（不得从事增值电信、金融业务）,销售:服装鞋帽、体育用品、日用百货、针纺织品、工艺品、家具、玩具、木制品、电子产品、陶瓷制品、家用电器、 办公文化用品、橡塑制品、纸制品、箱包、皮革制品,文化艺术交流策划,影视策划,会务服务,展览展示服务,设计、制作、代理、发布各类广告,从事货物及技术的进出口业务。【依法须经批准的项目,经相关部门批准后方可开展经营活动】
上海永乐股份有限公司	许可项目:演出经纪;电影发行;电影放映;出版物零售;歌舞娱乐活动;游艺娱乐活动;出版物批发;餐饮服务;食品销售;进出口代理;技术进出口;烟草制品零售。（依法须经批准的项目,经相关部门批准后方可开展经营活动,具体经营项目以相关部门批准文件或许可证件为准）一般项目:日用百货销售;五金产品批发;五金产品零售;金属材料销售;建筑材料销售;针纺织品销售;汽车零配件批发;非居住房地产租赁;物业管理;化工产品销售（不含许可类化工产品）;广告设计、代理;广告制作;广告发布;企业形象策划;食用农产品批发;化妆品批发;化妆品零售;纸制品销售;包装材料及制品销售;塑料制品销售;机械设备销售;供应链管理服务;园艺产品销售;办公用品销售;台球活动;健身休闲活动。（除依法须经批准的项目外,凭营业执照依法自主开展经营活动）
上海慈文影视传播有限公司	许可项目:广播电视节目制作经营;电视剧发行;电影发行。（依法须经批准的项目,经相关部门批准后方可开展经营活动,具体经营项目以相关部门批准文件或许可证件为准）一般项目:广告设计、代理;广告制作;广告发布;会议及展览服务;摄影扩印服务;组织文化艺术交流活动;市场营销策划;信息咨询服务（不含许可类信息咨询服务）;租赁服务（不含许可类租赁服务）;货物进出口;技术进出口;非居住房地产租赁。（除依法须经批准的项目外,凭营业执照依法自主开展经营活动）
上海天娱传媒有限公司	电视节目制作、发行;演出活动策划;商务咨询;经营演出及经纪业务（不含涉外及港澳台）;设计、制作、发布、代理国内各类广告。【依法须经批准的项目,经相关部门批准后方可开展经营活动】
上海星光电影股份有限公司	数字电影放映,文化艺术交流与策划,工艺品（象牙及其制品除外）的销售,会展会务服务,摄影服务（除扩印）,食品流通,食用农产品,放映设备销售,广告制作、发布,影院投资与管理,电影发行。【依法须经批准的项目,经相关部门批准后方可开展经营活动】
上海美术设计有限公司	展览展示设计服务,多媒体展示设计,家具、标识设计及专业领域内的技术服务,承办国内外进出口各类广告设计、制作、发布、代理及各类装潢业务,会务服务,礼仪服务,公共关系服务,舞台设计,电影院、影剧院放映系统工程的设计、配套、安装、调试,室内外装潢,建筑装饰工程设计,房屋建筑工程施工总承包,钢结构工程,建筑幕墙工程,机电设备安装工程,建筑智能化工程,文化艺术交流与策划,企业形象策划,企业管理咨询,市场营销策划,市场信息咨询与调查（社会调查、社会调研、民意调查、民意测验除外）,展览布置,模具图表,装潢美术,装饰材料,绘画,工具设备,日用工艺品（象牙及其制品除外）,广告资料摄录像,文化办公及美术用品,代办印刷业务,经营各类商品和技术的进出口（不另附进出口商品目录）,但国家限定公司经营或禁止进出口地商品及技术除外。【依法须经批准的项目,经相关部门批准后方可开展经营活动】
上海馔山文化传媒有限公司	许可项目:广播电视节目制作经营;演出经纪;第二类增值电信业务;药品互联网信息服务。（依法须经批准的项目,经相关部门批准后方可开展经营活动,具体经营项目以相关部门批准文件或许可证件为准）一般项目:个人互联网直播服务;互联网销售（除销售需要许可的商品）;组织文化艺术交流活动;会议及展览服务;礼仪服务;市场营销策划;市场调查（不含涉外调查）;技术服务、技术开发、技术咨询、技术交流、技术转让、技术推广;广告设计、代理;广告制作;广告发布;服装服饰批发;鞋帽批发;日用品销售;网络技术服务。（除依法须经批准的项目外,凭营业执照依法自主开展经营活动）
克丽丝汀迪奥商业（上海）有限公司	许可项目:出版物零售;食品销售;酒类经营;餐饮服务。（依法须经批准的项目,经相关部门批准后方可开展经营活动,具体经营项目以相关部门批准文件或许可证件为准）一般项目:服装服饰零售;服装服饰批发;服装辅料销售;鞋帽零售;鞋帽批发;皮革制品销售;珠宝首饰零售;珠宝首饰批发;珠宝首饰回收修理服务;日用百货销售;家居用品销售;日用杂品销售;眼镜销售（不含隐形眼镜）;化妆品零售;化妆品批发;电子产品销售;母婴用品销售;日用品销售;体育用品及器材零售;体育用品及器材批发;日用陶瓷制品销售;日用玻璃制品销售;厨具卫具及日用杂品零售;厨具卫具及日用杂品批发;家具销售;家具零配件销售;家具安装和维修服务;文具用品零售;文具用品批发;办公用品销售;工艺美术品及收藏品零售（象牙及其制品除外）;工艺美术品及收藏品批发（象牙及其制品除外）;自行车及零配件零售;自行车及零配件批发;自行车修理;摩托车及零配件零售;摩托车及零配件批发;机动车修理和维护;玩具销售;轻质建筑材料销售;模具销售;教学用模型及教具销售;货物进出口;餐饮管理;非居住房地产租赁;企业管理咨询;市场营销策划。（除依法须经批准的项目外,凭营业执照依法自主开展经营活动）
上海盛万影视文化有限公司	影视策划与咨询,文化艺术活动交流策划,企业形象策划,影片完片服务,文学创作,动漫、动画设计,设计、制作各类广告,利用自有媒体发布广告,摄影摄像,影视领域内的技术开发、技术服务、技术咨询,会展服务,礼仪服务,商务信息咨询（除经纪）。【依法须经批准的项目,经相关部门批准后方可开展经营活动】
上海实久文化传播有限公司	组织文化艺术交流活动,展览展示服务,设计、制作、代理、发布各类广告,企业形象策划,国内贸易（除专项规定）,投资咨询,房地产开发经营及咨询代理,物业管理,装潢五金。【依法须经批准的项目,经相关部门批准后方可开展经营活动】
上海久事体育产业发展（集团）有限公司	体育赛事策划、承办和运营,场馆设施经营管理,体育器材销售,体育经纪,票务代理,企业管理咨询,房屋建设工程施工,设计制作代理发布各类广告,物业管理,文化艺术活动交流策划、承办和运营,自有设备租赁,旅游咨询,计算机信息领域内的技术开发、技术转让、技术咨询服务,展览展示服务,货物和技术的进出口业务,酒店管理,高危险性体育项目（限分公司经营） 。【依法须经批准的项目,经相关部门批准后方可开展经营活动】
上海证券报社有限公司	证券报的出版、发行,证券信息,书刊,广告的设计、制作及利用自有媒体发布,附设分支机构。【依法须经批准的项目,经相关部门批准后方可开展经营活动】
铂格赛斯（上海）文化传媒有限公司	广播电视节目制作,电影发行,演出经纪,文化艺术交流策划咨询,设计、制作、代理各类广告,电脑图文设计制作,礼仪服务,会务服务,展览服务,摄影服务,动漫设计,舞台灯光设计,市场营销策划,企业形象策划,舞台艺术造型策划,公共关系咨询,餐饮企业管理,商务信息咨询,企业管理咨询,市场信息咨询与调查（不得从事社会调查、社会调研、民意调查、民意测验）,建筑装潢工程设计及施工。【依法须经批准的项目,经相关部门批准后方可开展经营活动】
中国唱片（上海）有限公司	一般项目：针纺织品、日用百货、橡胶制品、塑料制品、包装材料、音响设备、工艺礼品（象牙及其制品除外）、皮革制品、玩具、服装鞋帽、纸制品、办公用品、数码产品、电子产品的销售；广告设计、代理；广告制作；广告发布（非广播电台、电视台、报刊出版单位）；声频和视频工程、设备；电脑图文设计、制作；市场营销策划；企业形象策划；展览展示服务；文化艺术交流策划；自有房屋租赁。（除依法须经批准的项目外，凭营业执照依法自主开展经营活动）许可项目：出版物出版；音像制品复制；音像制品制作；电子出版物制作；出版物零售；出版物批发；货物进出口；技术进出口。（依法须经批准的项目，经相关部门批准后方可开展经营活动，具体经营项目以相关部门批准文件或许可证件为准）
上海润岭文化投资管理有限公司	文化项目投资,实业投资,投资管理。【依法须经批准的项目,经相关部门批准后方可开展经营活动】
洲业实业发展（上海）有限公司	一般项目:组织文化艺术交流活动;会议及展览服务;五金产品批发;五金产品零售;计算机软硬件及辅助设备批发;计算机软硬件及辅助设备零售;厨具卫具及日用杂品批发;化工产品销售（不含许可类化工产品）;销售金属材料、建筑装饰材料、金属制品、电子产品、机械设备、日用品、通讯设备、家用电器、日用百货、办公用品。（除依法须经批准的项目外,凭营业执照依法自主开展经营活动）许可项目:货物进出口;技术进出口。（依法须经批准的项目,经相关部门批准后方可开展经营活动,具体经营项目以相关部门批准文件或许可证件为准）
上海文艺出版社有限公司	图书、报刊的编辑、出版、批发、零售,实业投资,广告设计、发布、制作,社会经济咨询（除中介）。【依法须经批准的项目,经相关部门批准后方可开展经营活动】
上海影城有限公司	许可项目:电影放映;烟草制品零售;食品经营。（依法须经批准的项目,经相关部门批准后方可开展经营活动,具体经营项目以相关部门批准文件或许可证件为准）一般项目:展览展示服务,停车场库经营;文教用品、文化用品、工艺品（象牙及其制品除外）、百货、五金交电、皮革制品、服装,销售影视器材、音响设备、舞台设备、玩具、游艺器材;灯光系统设备销售、租赁（除金融租赁）、安装（除特种设备）,自有设备租赁（除金融租赁）;设计、制作、代理各类广告,利用自有媒体发布广告,投资管理（除股权投资和股权投资管理）,企业管理咨询（除经纪）,商务信息咨询（除经纪）,文化艺术活动交流策划,企业形象策划,市场营销策划,礼仪服务,会议服务,票务服务,影视领域内的技术开发、技术咨询、技术服务、技术转让,自有房屋租赁。（除依法须经批准的项目外,凭营业执照依法自主开展经营活动）
上海景懿资产管理有限公司	资产管理,投资管理。【依法须经批准的项目,经相关部门批准后方可开展经营活动】
上海十一维文化创意发展有限公司	一般项目:组织文化艺术交流活动;文艺创作;企业形象策划;市场营销策划;会议及展览服务;专业设计服务;停车场服务;企业管理咨询;技术服务、技术开发、技术咨询、技术交流、技术转让、技术推广;信息系统集成服务;非居住房地产租赁;信息咨询服务（不含许可类信息咨询服务）。（除依法须经批准的项目外,凭营业执照依法自主开展经营活动）
上海大都会育乐发展有限公司	各类球类练习场、健身房,游泳池,附设会员专用餐厅、卖品部、桑拿、美容室;音乐餐厅、桌球;生产各类球具,球、运动手套,销售自产产品,高尔夫运动培训中心,会员附属设施的物业管理;在批租地块内从事商品房的开发、经营、销售、物业管理,提供咨询服务。【依法须经批准的项目,经相关部门批准后方可开展经营活动】
上海柠萌影视传媒股份有限公司	许可项目:广播电视节目制作经营;电影发行。（依法须经批准的项目,经相关部门批准后方可开展经营活动,具体经营项目以相关部门批准文件或许可证件为准）一般项目:组织文化艺术交流活动;市场营销策划;会议及展览服务;摄影扩印服务;翻译服务;文化用品设备出租;文艺创作;广告设计、代理;广告制作;广告发布（非广播电台、电视台、报刊出版单位）。（除依法须经批准的项目外,凭营业执照依法自主开展经营活动）
未石互动科技股份有限公司	一般项目:从事数字技术、多媒体技术、自动化技术、计算机软硬件技术、图像科技领域内的技术开发、技术转让、技术咨询、技术服务,展览展示服务,计算机系统集成,数据处理和存储服务,动漫设计,软件开发,摄影摄像服务,网络工程,房屋建设工程施工,建筑装饰装修建设工程设计施工一体化,建筑智能化建设工程设计施工一体化,钢结构建设工程专业施工,机电安装建设工程施工,城市及道路照明建设工程专业施工,风景园林建设工程专项设计,机电设备安装建设工程专业施工,环保建设工程专业施工,建筑幕墙建筑工程专业施工,园林古建筑建设工程专业施工,消防设施建设工程专业施工,设计、制作各类广告,模型设计,电子产品、照明器材、工艺品（象牙及其制品除外）的销售。（除依法须经批准的项目外,凭营业执照依法自主开展经营活动）
旷世传声传媒科技集团有限责任公司	一般项目：组织文化艺术交流活动；软件开发；技术服务、技术开发、技术咨询、技术交流、技术转让、技术推广；信息技术咨询服务；信息咨询服务（不含许可类信息咨询服务）；计算机软硬件及辅助设备批发；计算机软硬件及辅助设备零售；平面设计；电子产品销售；办公设备耗材销售；办公设备销售；网络技术服务；信息系统集成服务；企业形象策划；社会经济咨询服务；数据处理和存储支持服务；会议及展览服务；商务代理代办服务；项目策划与公关服务。（除依法须经批准的项目外，凭营业执照依法自主开展经营活动）
上海华奥电竞信息科技有限公司	一般项目:从事计算机软硬件、网络技术领域内的技术开发、技术转让、技术咨询、技术服务,计算机软硬件及辅助设备批发;计算机软硬件及辅助设备零售;服装服饰零售;互联网销售（除销售需要许可的商品）;家用电器销售;家用视听设备销售;日用百货销售;日用品销售;玩具、动漫及游艺用品销售;移动终端设备销售;游艺及娱乐用品销售,设计、制作、代理各类广告,文化艺术交流策划,票务代理。（除依法须经批准的项目外,凭营业执照依法自主开展经营活动）许可项目:货物进出口;技术进出口;网络文化经营;广播电视节目制作经营;演出经纪。（依法须经批准的项目,经相关部门批准后方可开展经营活动,具体经营项目以相关部门批准文件或许可证件为准）
上海广迪娱乐有限公司	许可项目:歌舞娱乐活动;食品经营;餐饮服务;烟草制品零售;酒类经营。（依法须经批准的项目,经相关部门批准后方可开展经营活动,具体经营项目以相关部门批准文件或许可证件为准）一般项目:会议及展览服务;日用百货销售;服装服饰零售;鞋帽批发;针纺织品销售;办公用品销售;日用品销售;工艺美术品及礼仪用品销售（象牙及其制品除外）。（除依法须经批准的项目外,凭营业执照依法自主开展经营活动）
上海千逸文化传播有限公司	文化艺术交流策划（除演出经纪）,市场营销策划,设计、制作、代理各类广告,会务礼仪服务,展览展示服务,商务咨询,电脑图文制作,销售文化办公用品、电脑软硬件及耗材、广告器材。【依法须经批准的项目,经相关部门批准后方可开展经营活动】
上海世纪出版股份有限公司	编辑出版、出版经营和管理,上海世纪出版集团出版的图书报刊、电子出版物的批发、零售、仓储、物业管理、停车场（库）经营、会展服务,实业投资,国内贸易（除专项审批项目）,经济咨询服务。【依法须经批准的项目,经相关部门批准后方可开展经营活动】
上海证大文化创意发展有限公司	文化艺术交流活动策划（演出经纪除外），企业形象策划，公关活动策划；舞台艺术设计，室内装潢设计，工艺礼品设计，广告设计和制作；会议会展服务（主办、承办除外），婚庆、礼仪服务；商务信息咨询（金融信息除外）；酒店管理；服装服饰、日用百货、酒店用品、办公用品的批发、网上销售、佣金代理（拍卖除外）和进出口，提供相关配套服务（不涉及国营贸易管理商品，涉及配额、许可证管理商品的，按照国家有关规定办理申请）。【依法须经批准的项目，经相关部门批准后方可开展经营活动】
上海四次元文化集团有限公司	文化艺术交流策划，企业管理服务，企业管理咨询，从事旅游设备科技、影视科技、旅游用品科技、计算机信息科技领域内的技术开发、技术咨询、技术服务、技术转让，商务信息咨询，演出经纪，食品销售，旅游咨询，酒店管理，餐饮企业管理，展览展示服务，市场营销策划，自有设备租赁，停车场经营管理，游乐设备、旅游用品、工艺礼品的批发、零售，电子设备、机械设备的批发、零售、安装、维修，品牌设计，品牌管理，品牌策划，会务服务，礼仪服务，旅客票务代理，物业管理，设计、制作、代理、发布各类广告，利用自有媒体发布广告，房地产营销策划，房地产咨询，旅游项目开发，旅行社业务，文艺创作与表演。【依法须经批准的项目，经相关部门批准后方可开展经营活动】
上海阿凡提投资控股集团有限公司	实业投资、投资管理;动漫设计,各类广告的设计、制作;投资咨询,房地产咨询（以上咨询不得从事经纪）;市场营销策划;计算机软硬件领域内的技术开发、技术转让、技术咨询、技术服务;电子商务（不得从事增值电信、金融业务）,广播电视节目制作、发行 。【依法须经批准的项目,经相关部门批准后方可开展经营活动】
上海耀客文化股份有限公司	许可项目:广播电视节目制作经营。（依法须经批准的项目,经相关部门批准后方可开展经营活动,具体经营项目以相关部门批准文件或许可证件为准）一般项目:电视剧发行;文艺创作;广告设计、代理;广告制作;广告发布（非广播电台、电视台、报刊出版单位）;信息咨询服务（不含许可类信息咨询服务）;咨询策划服务;企业形象策划;市场营销策划;影视领域内的技术开发、技术转让、技术咨询、技术服务;影视器材、服装、道具租赁及批发零售。（除依法须经批准的项目外,凭营业执照依法自主开展经营活动）
前海盛世文化控股（深圳）有限公司	一般经营项目是:艺术品的评估、销售;文化活动策划(不涉及外商投资准入特别管理措施);企业形象策划;文化用品、珠宝首饰、金银首饰、钻石首饰、雕刻工艺品、工艺品、织制工艺品、工艺美术品的批发、零售(不涉及外商投资准入特别管理措施)、进出口相关配套业务(涉及国营贸易、配额、许可证及专项管理规定的商品,按国家有关规定办理申请后经营)。其他文化艺术经纪代理;组织文化艺术交流活动。凭营业执照依法自主开展经营活动),许可经营项目是:营业性演出;演出场所经营;演出经纪。(,具体经营项目以相关部门批准文件或许可证件为准)
桑杰文化发展集团有限公司	组织文化艺术交流活动（不含演出）；承办展览展示；基础软件服务；技术开发、技术转让、技术咨询、技术服务、技术推广；投资咨询；资产管理；经济贸易咨询；货物进出口；技术进出口；代理进出口；设计、制作、代理、发布广告；销售工艺品、珠宝首饰、食用农产品；旅游信息咨询；餐饮管理；酒店管理；企业管理；票务代理（不含航空机票销售代理）；城市园林绿化施工；境内旅游业务；销售食品。（企业依法自主选择经营项目，开展经营活动；境内旅游业务、销售食品以及依法须经批准的项目，经相关部门批准后依批准的内容开展经营活动；不得从事本市产业政策禁止和限制类项目的经营活动。）
环球电广影视传媒集团有限公司	广播电视节目制作;项目投资;投资管理;企业管理;c;广告信息咨询;会议服务;承办展览展示活动;商务信息咨询。（企业依法自主选择经营项目,开展经营活动;广播电视节目制作以及依法须经批准的项目,经相关部门批准后依批准的内容开展经营活动;不得从事本市产业政策禁止和限制类项目的经营活动。）
霍氏文化产业集团有限公司	研制汽车养护品;组织文化艺术交流活动（不含演出）;影视策划;开发汽车养护品;技术开发;技术咨询;技术服务;投资管理;项目投资;经济信息咨询;企业形象设计;家居装饰;计算机平台设计;销售机械设备、电器设备、金属材料、木材、汽车配件、五金交电、针纺织品、百货、电子计算机及配件、土产品、建筑材料、橡胶制品、工艺美术品、花卉;建筑工程机械租赁;物业管理。（企业依法自主选择经营项目,开展经营活动;依法须经批准的项目,经相关部门批准后依批准的内容开展经营活动;不得从事本市产业政策禁止和限制类项目的经营活动。）
徽商故里文化发展集团有限公司	组织文化艺术交流（不含演出）;承办展览展示活动;技术开发、技术咨询、技术服务、技术培训;家居装饰;销售建筑材料、机械电器设备、化工产品（不含一类易制毒化学品及危险品）、五金交电、制冷空调设备、计算机软硬件及外围设备、百货、装饰材料、工艺品;食品经营（仅销售预包装食品）;限分支机构经营:制售中餐（含冷荤凉菜）;销售酒、饮料。（市场主体依法自主选择经营项目,开展经营活动;依法须经批准的项目,经相关部门批准后依批准的内容开展经营活动;不得从事国家和本市产业政策禁止和限制类项目的经营活动。）
鸿蒙墅苑文化集团有限公司	广播电视节目制作；音乐表演、戏剧表演（仅限分支机构经营）；组织文化交流活动（演出除外）；会议服务；承办展览展示；投资管理；信息咨询（中介除外）；教育咨询；健身服务；出租商业用房；出租办公用房；自然科学与试验发展；技术开发；文艺创作；企业管理；销售日用品、工艺品。（企业依法自主选择经营项目，开展经营活动；广播电视节目制作以及依法须经批准的项目，经相关部门批准后依批准的内容开展经营活动；不得从事本市产业政策禁止和限制类项目的经营活动。）
中国环境出版集团有限公司	环境管理、环境工程、环境法学、环境经济、环境监测等专业的基础理论、学术著作、应用技术和环境文化、环境教材以及有关环境保护的科普读物、工具书、画册（有效期至2021年12月31日）;广告业务;版权贸易;环境风险评估;环保产业开发;仓储;与以上业务相关的信息服务、咨询;会展服务;房屋租赁;计算机技术培训;环保技术培训;企业管理培训;广播电视节目制作;电影发行;电影放映;电影摄制;电视剧制作。（企业依法自主选择经营项目,开展经营活动;广播电视节目制作;电影发行;电影放映;电影摄制;电视剧制作以及依法须经批准的项目,经相关部门批准后依批准的内容开展经营活动;不得从事本市产业政策禁止和限制类项目的经营活动。）
大业传媒集团有限公司	广播电视节目制作;设计、制作、代理、发布各类广告。（市场主体依法自主选择经营项目,开展经营活动;广播电视节目制作以及依法须经批准的项目,经相关部门批准后依批准的内容开展经营活动;不得从事国家和本市产业政策禁止和限制类项目的经营活动。）
炎黄文化产业集团有限公司	组织文化艺术交流活动（演出除外）;会议服务;承办展览展示活动;项目投资;投资管理;技术推广;投资咨询;电影摄制;电影发行;电视剧制作。（企业依法自主选择经营项目,开展经营活动;电影摄制、电影发行、电视剧制作以及依法须经批准的项目,经相关部门批准后依批准的内容开展经营活动;不得从事本市产业政策禁止和限制类项目的经营活动。）
北京龙世文化集团有限公司	组织文化艺术交流活动;文艺演出票务代理;筹备、策划、组织电影节;筹备、策划、组织文化节;承办展览展示活动;设计、制作、代理、发布国内及外商来华广告;广告信息咨询;销售工艺品、日用品;货物进出口;技术进出口;代理进出口;广播电视节目制作;演出经纪;经营电信业务;从事互联网文化活动。（市场主体依法自主选择经营项目,开展经营活动;演出经纪、从事互联网文化活动、经营电信业务、广播电视节目制作以及依法须经批准的项目,经相关部门批准后依批准的内容开展经营活动;不得从事国家和本市产业政策禁止和限制类项目的经营活动。）
神玉文化集团有限公司	组织国内文化艺术交流活动（演出除外）;健身服务;乒乓球;羽毛球;承办展览展示;广告设计制作;技术培训、技术咨询、技术服务、技术开发;会议服务;销售文体用品。（依法须经批准的项目,经相关部门批准后依批准的内容开展经营活动。）
皇氏御嘉影视集团有限公司	制作、发行动画片、电视综艺、专题片;经营演出及经纪业务;组织文化艺术交流活动。（市场主体依法自主选择经营项目,开展经营活动;依法须经批准的项目,经相关部门批准后依批准的内容开展经营活动;不得从事国家和本市产业政策禁止和限制类项目的经营活动。）
丝绸之路商道文化集团有限公司	组织文化艺术交流活动（不含演出）;组织体育交流活动;技术开发、技术咨询、技术转让、技术服务、技术推广;销售汽车、船舶、陶瓷制品、珠宝首饰、工艺美术品、日用品、服装、文化用品、针纺织品、乐器、家具、家用电器、电子产品、五金交电、建筑材料、计算机、机械设备、通讯设备;微特电机及组件制造;企业管理;货物进出口、技术进出口、代理进出口;承办展览展示;食品经营（仅销售预包装食品）;会议服务;设计、制作、代理、发布广告;电影发行;广播电视节目制作。（市场主体依法自主选择经营项目,开展经营活动;电影发行、广播电视节目制作以及依法须经批准的项目,经相关部门批准后依批准的内容开展经营活动;不得从事国家和本市产业政策禁止和限制类项目的经营活动。）
传奇文化发展集团有限公司	组织文化艺术交流活动;房地产开发;物业管理;从事房地产经纪业务;企业策划;项目投资;投资管理;企业管理;经济贸易咨询;市场调查;承办展览展示活动;设计、制作、代理、发布广告;商标代理;版权贸易;翻译服务;酒店管理;会议及展览服务;销售日用品、服装、工艺品、针纺织品、建筑材料、树木（不含苗木）、花卉、机械设备;旅游信息咨询;企业策划;企业管理咨询;工程管理服务;租赁建筑工程机械设备;演出经纪;文艺表演;演出经纪。（市场主体依法自主选择经营项目,开展经营活动;文艺表演、演出经纪以及依法须经批准的项目,经相关部门批准后依批准的内容开展经营活动;不得从事国家和本市产业政策禁止和限制类项目的经营活动。）
天合文化集团有限公司	组织文化艺术交流活动（不含演出）;技术咨询、技术服务;计算机技术培训;信息咨询（中介除外）;设计、制作、代理、发布各类广告;版权代理。（市场主体依法自主选择经营项目,开展经营活动;依法须经批准的项目,经相关部门批准后依批准的内容开展经营活动;不得从事国家和本市产业政策禁止和限制类项目的经营活动。）
中侨佳信文化集团有限公司	一般项目:组织文化艺术交流活动;文艺创作;会议及展览服务;工艺美术品及收藏品零售（象牙及其制品除外）;珠宝首饰零售;艺（美）术品、收藏品鉴定评估服务;企业管理咨询;社会经济咨询服务;市场营销策划;广告发布;专业设计服务;摄影扩印服务;技术服务、技术开发、技术咨询、技术交流、技术转让、技术推广;软件开发;软件外包服务;人工智能应用软件开发;信息技术咨询服务;智能农业管理;农业生产托管服务;休闲观光活动;土地整治服务。（除依法须经批准的项目外,凭营业执照依法自主开展经营活动）许可项目:广播电视节目传送;网络文化经营;证券投资咨询;出版物零售;营业性演出;电影放映;电影发行;互联网新闻信息服务;农业转基因生物加工。（依法须经批准的项目,经相关部门批准后方可开展经营活动,具体经营项目以相关部门批准文件或许可证件为准）（不得从事国家和本市产业政策禁止和限制类项目的经营活动。）
万万星帝集团有限公司	一般项目:文艺创作;组织文化艺术交流活动;健身休闲活动;体育场地设施经营（不含高危险性体育运动）;休闲观光活动;游乐园服务;广告发布;社会经济咨询服务;会议及展览服务;企业形象策划;城市绿化管理;技术服务、技术开发、技术咨询、技术交流、技术转让、技术推广;信息咨询服务（不含许可类信息咨询服务）;广告设计、代理;广告制作;玩具销售;日用品销售;珠宝首饰零售;金属制品销售;钟表销售;工艺美术品及收藏品零售（象牙及其制品除外）;花卉种植;树木种植经营;电影摄制服务;物业管理;工程管理服务;企业管理;市场调查（不含涉外调查）;非居住房地产租赁;房地产经纪;热力生产和供应。（除依法须经批准的项目外,凭营业执照依法自主开展经营活动）许可项目:广播电视节目制作经营;电影发行;演出经纪;水产养殖;房地产开发经营。（依法须经批准的项目,经相关部门批准后方可开展经营活动,具体经营项目以相关部门批准文件或许可证件为准）（不得从事国家和本市产业政策禁止和限制类项目的经营活动。）
一壹传媒集团有限公司	广播电视节目制作;影视策划;组织文化艺术交流活动（不含演出）;设计、制作、代理、发布广告;会议服务;技术推广服务;经济贸易咨询;租赁服装、道具、摄影器材;摄影扩印服务;销售机械设备;企业管理咨询;投资管理;资产管理;投资咨询;项目投资;企业策划;计算机技术培训;市场调查;承办展览展示活动。（市场主体依法自主选择经营项目,开展经营活动;广播电视节目制作以及依法须经批准的项目,经相关部门批准后依批准的内容开展经营活动;不得从事国家和本市产业政策禁止和限制类项目的经营活动。）
长安动漫产业集团有限公司	制作,发行动画片、专题片、电视综艺,不得制作时政新闻及同类专题、专栏等广播电视节目（广播电视节目制作许可证有效期至2021年03月31日）;图书、报纸、期刊、电子出版物、音像制品零售（出版物经营许可证有效期至2022年04月30日）;房地产开发;物业管理;设计、制作、发布广告;投资及投资管理;研发与销售动漫游戏设备、游乐设施、玩具、工艺品、小饰品、礼品;动漫软件、硬件研发生产;计算机系统集成;货物进出口;技术进出口;代理进出口;组织文化艺术交流活动（演出除外）;承办展览展示活动;动漫人员技术培训。（市场主体依法自主选择经营项目,开展经营活动;房地产开发以及依法须经批准的项目,经相关部门批准后依批准的内容开展经营活动;不得从事国家和本市产业政策禁止和限制类项目的经营活动。）
北京东方文化经济发展集团有限公司	零售、邮购、二级批发国内版图书;演出经纪;投资咨询;投资管理;组织国内文化交流活动（承办文艺演出除外）;组织文化体育活动;技术开发、技术转让、技术服务;信息咨询服务（中介服务除外）;自有房产的物业管理（含出租写字间）;承办展览展示活动;会议服务;接受委托代售门票。（“1、未经有关部门批准,不得以公开方式募集资金;2、不得公开开展证券类产品和金融衍生品交易活动;3、不得发放贷款;4、不得对所投资企业以外的其他企业提供担保;5、不得向投资者承诺投资本金不受损失或者承诺最低收益”;企业依法自主选择经营项目,开展经营活动;演出经纪依法须经批准的项目,经相关部门批准后依批准的内容开展经营活动;不得从事本市产业政策禁止和限制类项目的经营活动。）
华夏文广传媒集团股份有限公司	组织文化艺术交流活动;会议服务;承办展览展示活动;设计、制作、代理、发布广告;影视策划;企业策划;市场调查;市场营销;电脑图文设计、制作;计算机网络信息系统技术服务;工艺美术设计;销售通讯及广播电视设备、数字音频设备、工艺品;高清晰度影视技术、宽带信息技术数码、网络系统集成的技术开发维护、技术服务;企业管理咨询;企业策划;电脑动画设计、制作;软件开发;产品设计;服装设计;数据处理;技术推广服务;经营电信业务;广播电视节目制作;演出经纪;从事互联网文化活动;互联网信息服务。（市场主体依法自主选择经营项目,开展经营活动;经营电信业务、广播电视节目制作、演出经纪、从事互联网文化活动、互联网信息服务以及依法须经批准的项目,经相关部门批准后依批准的内容开展经营活动;不得从事国家和本市产业政策禁止和限制类项目的经营活动。）
北京北广传媒集团有限公司	制作、发行动画片、电视综艺、专题片（不得制作时政新闻及同类专题、专栏等广播电视节目）；投资及资产管理；设计、制作广告；承办展览展示活动；组织文化艺术交流活动（不含演出）；技术开发、技术转让、技术服务、技术咨询；通讯技术培训；企业策划；经济信息咨询；销售机械电器设备、文化体育用品、办公机械；租赁广播电视设备。（市场主体依法自主选择经营项目，开展经营活动；依法须经批准的项目，经相关部门批准后依批准的内容开展经营活动；不得从事国家和本市产业政策禁止和限制类项目的经营活动。）
北京万达文化产业集团有限公司	组织文化艺术交流活动（不含演出）;文化产业项目投资;投资管理、投资咨询;企业管理咨询;经济贸易咨询。（市场主体依法自主选择经营项目,开展经营活动;依法须经批准的项目,经相关部门批准后依批准的内容开展经营活动;不得从事国家和本市产业政策禁止和限制类项目的经营活动。）
中国国际图书贸易集团有限公司	许可项目:出版物批发;出版物进口;出版物零售;出版物互联网销售;艺术品进出口;保税物流中心经营。（依法须经批准的项目,经相关部门批准后方可开展经营活动,具体经营项目以相关部门批准文件或许可证件为准）一般项目:货物进出口;技术进出口;进出口代理;国内贸易代理;艺术品代理;版权代理;采购代理服务;招投标代理服务;票务代理服务;数据处理服务;数字内容制作服务（不含出版发行）;图书管理服务;翻译服务;图书出租;信息咨询服务（不含许可类信息咨询服务）;知识产权服务（专利代理服务除外）;技术服务、技术开发、技术咨询、技术交流、技术转让、技术推广;软件外包服务;广告制作;广告发布;项目策划与公关服务;组织文化艺术交流活动;会议及展览服务;图文设计制作;其他文化艺术经纪代理;非居住房地产租赁;普通货物仓储服务（不含危险化学品等需许可审批的项目）;国内货物运输代理;国际货物运输代理;报检业务;报关业务;互联网销售（除销售需要许可的商品）;日用百货销售;母婴用品销售;玩具、动漫及游艺用品销售;电子产品销售;办公用品销售;工艺美术品及收藏品批发（象牙及其制品除外）;教学专用仪器销售;教学用模型及教具销售;体育用品及器材零售;服装服饰零售;乐器零售;照相机及器材制造;照相机及器材销售;食品销售（仅销售预包装食品）;第一类医疗器械销售;第二类医疗器械销售;医用口罩批发。（除依法须经批准的项目外,凭营业执照依法自主开展经营活动）（不得从事国家和本市产业政策禁止和限制类项目的经营活动。）
中广传播集团有限公司	广播电视节目制作经营；卫星移动广播项目投资策划、咨询服务；卫星信号传输服务；广播电视卫星传输服务系统设计和咨询服务；广播影视卫星技术开发、信息和技术咨询服务；广播电视器材及设备、电子产品的销售；广播电视系统工程建设；广播与通信系统研发、系统集成；手机销售；广告业务。（市场主体依法自主选择经营项目，开展经营活动；广播电视节目制作经营以及依法须经批准的项目，经相关部门批准后依批准的内容开展经营活动；不得从事国家和本市产业政策禁止和限制类项目的经营活动。）
中信出版集团股份有限公司	围绕中信公司业务,出版金融贸易、生产技术方面的图书,以及围绕国际市场的发展趋向,出版介绍国际经济发展、国际市场预测的图书（有效期至2021年12月31日）;出版财经、文化、生活类电子出版物（有效期至2025-06-30）;出版财经、文化、生活类音像制品（有效期至2025年06月30日）;同本公司出版范围一致的互联网图书、手机图书出版（有效期至2021年12月31日）;图书、报纸、期刊、电子出版物、音像制品批发、零售、网上销售（有效期至2022年04月30日）;出版物零售（出版物经营许可证有效期至2022年04月30日）;演出经纪;互联网信息服务;广播电视节目制作经营;信息网络传播视听节目;设计、制作图书广告,利用本出版社出版的图书发布广告;办公用品、百货、工艺美术品、电子产品的销售;承办展览展示;会议服务;营销策划;管理咨询;社会经济咨询。（市场主体依法自主选择经营项目,开展经营活动;演出经纪、互联网信息服务、广播电视节目制作经营、信息网络传播视听节目及依法须经批准的项目,经相关部门批准后依批准的内容开展经营活动;不得从事国家和本市产业政策禁止和限制类项目的经营活动。）
松雷国际文化创意产业集团有限公司	出版物零售；销售食品；音乐剧、话剧、舞剧创作；电影电视剧剧本策划及创作；经营演出及经纪业务；承办展览展示活动；组织文化艺术交流活动；文化艺术作品创作；动漫设计制作；科技美术计算机软件开发；经济贸易咨询；企业管理咨询；会议服务；装饰设计；图文设计、制作；设计、制作、代理、发布广告；技术推广服务；销售化妆品、日用品、工艺品、文化用品、服装、鞋帽、乐品、电子产品、体育用品；货物进出口、技术进出口、代理出口；酒店管理；出租商业用房；体育运动经营（高危体育运动项目除外）；体育经纪；教育咨询；物业管理。（市场主体依法自主选择经营项目，开展经营活动；出版物零售；销售食品。以及依法须经批准的项目，经相关部门批准后依批准的内容开展经营活动；不得从事国家和本市产业政策禁止和限制类项目的经营活动。）
龙沙国际文化集团有限公司	制作、发行动画片、电视综艺、专题片;投资管理;资产管理;经济信息咨询;技术服务;电脑动画设计;专业承包;办公设备维修;打字、复印;设计、制作（仅限计算机制作）、代理、发布广告;销售日用品、金属材料、建筑材料、化工产品（不含一类易制毒化学品及危险品）、机械设备、五金交电、通讯器材、计算机、软件及辅助设备;专用设备;筹备、策划、组织文化节、艺术节;市场调查;会议服务;承办展览展示活动。（市场主体依法自主选择经营项目,开展经营活动;依法须经批准的项目,经相关部门批准后依批准的内容开展经营活动;不得从事国家和本市产业政策禁止和限制类项目的经营活动。）
中文在线数字出版集团股份有限公司	互联网图书、互联网文学、互联网期刊、互联网教育出版物出版、手机出版;互联网游戏、手机游戏出版（网络出版服务许可证有效期至2021年12月31日）;图书、期刊、电子出版物 批发、零售、网上销售（中华人民共和国出版物经营许可证有效期至2022年4月30日）;信息服务业务（仅限互联网信息服务）不含信息搜索查询服务、信息社区服务、信息即时交互服务和信息保护和加工处理服务（中华人民共和国增值电信业务经营许可证有效期至2022年03月15日）;利用信息网络经营动漫产品（网络文化经营许可证有效期至2023年12月01日）;电子出版物（限于电子书）复制业务,包括:出版物内容的数字转换、编辑加工、数字芯片植入（中华人民共和国复制经营许可证有效期至2023年2月28日）;信息服务业务（不含互联网信息服务）全国（中华人民共和国增值电信业务经营许可证有效期至2022年03月23日）;制作、发行 动画片、专题片、电视综艺、不得制作时政新闻及同类专题、专栏等广播电视节目（广播电视节目制作经营许可证有效期至2022年05月08日）;电视剧制作;电影发行;出租办公用房、出租商业用房;组织文化艺术交流活动;技术开发、转让、咨询、服务、培训;信息源技术服务;零售开发后的产品;经济信息咨询（除中介服务）;投资咨询;图文电脑设计;承办展览展示活动;代理发布广告;货物进出口、技术进出口、代理进出口。（市场主体依法自主选择经营项目,开展经营活动;以及依法须经批准的项目,经相关部门批准后依批准的内容开展经营活动;不得从事国家和本市产业政策禁止和限制类项目的经营活动。）
中视实业集团有限公司	许可项目:职业中介活动;建筑智能化系统设计;电气安装服务;住宅室内装饰装修;保险兼业代理业务;烟草制品零售;食品销售;广播电视节目制作经营;第二类增值电信业务。（依法须经批准的项目,经相关部门批准后方可开展经营活动,具体经营项目以相关部门批准文件或许可证件为准）一般项目:数字内容制作服务（不含出版发行）;影视美术道具置景服务;信息技术咨询服务;广播电视传输设备销售;广播电视设备专业修理;互联网销售（除销售需要许可的商品）;机械设备销售;计算机软硬件及辅助设备零售;金属制品销售;五金产品零售;办公设备销售;针纺织品销售;服装服饰零售;工艺美术品及收藏品零售（象牙及其制品除外）;日用百货销售;家用电器销售;建筑材料销售;化工产品销售（不含许可类化工产品）;汽车销售;汽车零配件零售;技术服务、技术开发、技术咨询、技术交流、技术转让、技术推广;计算机及办公设备维修;社会经济咨询服务;装卸搬运;专业保洁、清洗、消毒服务;家政服务;物业管理;摄影扩印服务;服装制造;打字复印;人力资源服务（不含职业中介活动、劳务派遣服务）;小微型客车租赁经营服务;广告发布;广告设计、代理;广告制作;金银制品销售;珠宝首饰零售。（除依法须经批准的项目外,凭营业执照依法自主开展经营活动）（不得从事国家和本市产业政策禁止和限制类项目的经营活动。）
华风气象传媒集团有限责任公司	制作广播电视节目;《中国气象视频网》自办播放业务;第二类增值电信业务中的信息服务业务（不含固定网电话信息服务和互联网信息服务）;因特网信息服务业务（除新闻、出版、教育、医疗保健、药品、医疗器械和BBS以外的内容）;影视信息与气象信息咨询服务;天气预报节目、电视专题节目、电视综艺节目、动画节目的策划;电视多媒体及软件的设计;电子产品、通信设备、仪器仪表的技术开发、技术服务、销售;设计、制作、代理、发布国内及外商来华广告;房地产开发;货物进出口、技术进出口、代理进出口。（领取本执照后,应到商务委员会备案。企业依法自主选择经营项目,开展经营活动;依法须经批准的项目,经相关部门批准后依批准的内容开展经营活动;不得从事本市产业政策禁止和限制类项目的经营活动。）
航美传媒集团有限公司	广播电视节目制作;互联网信息服务;设计、制作、代理、发布广告;广告信息咨询;销售日用品、纺织品、服装鞋帽、化妆品、卫生用品、钟表、箱、包、眼镜、黄金制品、珠宝首饰、五金、交电、照相器材、电子产品、计算机及辅助设备、家具、工艺品、文化用品、体育用品、I类医疗器械、II类医疗器械;货物进出口;经济贸易咨询;技术开发、技术转让、技术咨询、技术服务。（市场主体依法自主选择经营项目,开展经营活动;互联网信息服务、广播电视节目制作以及依法须经批准的项目,经相关部门批准后依批准的内容开展经营活动;不得从事国家和本市产业政策禁止和限制类项目的经营活动。）
清华大学出版社有限公司	出版、发行《纳米研究（英文版）》（期刊出版许可证有效期至2023年12月31日）;出版、发行《社会主义核心价值观研究》（期刊出版许可证有效期至2023年12月31日）;出版、发行《摩擦（英文）》（期刊出版许可证有效期至2023年12月31日）;出版、发行《计算可视媒体（英文）》（期刊出版许可证有效期至2023年12月31日）;出版、发行《全球传媒学刊》（期刊出版许可证有效期至2023年12月31日）;出版、发行《高校马克思主义理论研究》（期刊出版许可证有效期至2023年12月31日）;出版、发行《城市设计》（期刊出版许可证有效期至2023年12月31日）;出版、发行《神经科学（英文）》（期刊出版许可证有效期至2023年12月31日）;出版物零售;出版本校设置的学科、专业、课程所需要的教材;本校教学所需要的教学参考书、教学工具书;与本校主要专业方向相一致的学术专著、译著;适合高等学校教学需要的通俗政治理论读物,为我国高校出同一专业系统的高校教材;出版外语教学图书及相应的磁带;出版计算机图书及相应的软件、光盘;出版与本校专业方向一致的电子出版物;出版教育类及实用科技普及类音像制品;互联网学术出版物、互联网图书、互联网教育出版物;出版《临床转化神经医学（英文网络版）》网络连续型出版物（CN11-6030/R）（网络出版服务许可证有效期至2021年12月31日）;广播电视节目制作;出租办公用房;组织文化艺术交流活动（不含营业性演出）;教育咨询（中介服务除外）;企业管理咨询;技术开发、技术推广、技术服务;设计、制作、代理、发布广告。（市场主体依法自主选择经营项目,开展经营活动;出版物零售、互联网学术出版物、互联网图书、互联网教育出版物;出版《临床转化神经医学（英文网络版）》网络连续型出版物（CN11-6030/R）、广播电视节目制作以及依法须经批准的项目,经相关部门批准后依批准的内容开展经营活动;不得从事国家和本市产业政策禁止和限制类项目的经营活动。）
北京北奥集团有限责任公司	经营演出及经纪业务;销售食品;文艺创作;健身服务;会议及展览服务;企业策划、设计;工程管理服务;出租办公用房;出租商业设施;出租商业用房;物业管理;技术开发、技术咨询、技术服务;产品设计;货物进出口;技术进出口;组织体育赛事、体育赛事策划、体育赛事咨询;组织体育文化交流活动（不含演出）;从事体育经纪;设计、制作、代理、发布国内外广告;销售体育用品、日用品、针织纺品、服装、鞋帽、工艺品;机动车公共停车场服务;舞台道具制作;体育技术培训、技术推广;体育运动项目经营;体育场馆经营（游泳馆除外）;企业管理咨询;财务咨询（不得开展审计、验资、查账、评估、会计咨询、代理记账等专项审批的业务,不得出具相应的审计报告、验资报告、查账报告、评估报告等文字材料）;票务代理服务。（市场主体依法自主选择经营项目,开展经营活动;依法须经批准的项目,经相关部门批准后依批准的内容开展经营活动;不得从事国家和本市产业政策禁止和限制类项目的经营活动。）
北京恒岳索通集团有限公司	组织文化艺术交流活动（不含演出）;体育运动项目经营（高危险性体育项目除外）;技术开发、转让、培训（不得面向全国招生）、咨询（不含中介服务）、服务;旅游资源开发（不含旅游业务）;销售化工产品（不含危险化学品）、机械设备、电气设备;专业承包;燃气经营;出租办公用房、商业用房;汽车租赁;货物进出口、代理进出口、技术进出口;普通货运;销售食品;餐饮服务（在居民住宅楼、未配套设立专用烟道的商住综合楼、商住综合楼内与居住层相邻的商业楼层内产生油烟、异味、废气）。（市场主体依法自主选择经营项目,开展经营活动;销售食品;餐饮服务（在居民住宅楼、未配套设立专用烟道的商住综合楼、商住综合楼内与居住层相邻的商业楼层内产生油烟、异味、废气）以及依法须经批准的项目,经相关部门批准后依批准的内容开展经营活动;不得从事国家和本市产业政策禁止和限制类项目的经营活动。）
体育之窗文化股份有限公司	组织文化艺术交流;承办展览展示;物业管理;企业管理咨询;投资咨询;经济信息咨询;市场调查;房地产咨询;出租房屋;设计、制作、代理、发布广告;票务代理;体育项目经营（高危险性体育项目除外）;从事体育经纪业务;体育赛事票务代理;网络技术开发、技术服务、技术转让、技术咨询;应用软件服务;基础软件服务;销售服装、鞋帽、日用品、电子产品、家用电器、文具用品、计算机、软硬件及辅助设备、机械设备、玩具、通讯设备、文化用品、体育用品、首饰、家具、建筑材料、汽车零配件、针纺织品、酒店用品、塑料制品、洗涤用品、化妆品、箱包、五金交电、金属材料、机电设备及配件、制冷设备及配件、食品 ;演出经纪。（市场主体依法自主选择经营项目,开展经营活动;演出经纪、销售食品以及依法须经批准的项目,经相关部门批准后依批准的内容开展经营活动;不得从事国家和本市产业政策禁止和限制类项目的经营活动。）
《中国企业报》股份有限公司	出版《中国企业报》；投资与资产管理；设计、制作、代理、发布广告；教育咨询；承办承览展示活动；会议服务；出租办公用房；出租商业用房；技术咨询；企业管理；经济贸易咨询；文化咨询；企业策划；体育运动项目经营（高危险性体育项目除外）；组织文化艺术交流活动（不含营业性演出）；物业管理。（企业依法自主选择经营项目，开展经营活动；依法须经批准的项目，经相关部门批准后依批准的内容开展经营活动；不得从事本市产业政策禁止和限制类项目的经营活动。）
保利文化集团股份有限公司	演出及经纪业务;组织文化艺术活动;演出票务代理;字画、工艺美术品（金饰品除外）、旅游纪念品的销售;演出器材的销售、租赁;艺术装饰;艺术品展示;舞台美术、工艺美术品、包装装璜设计、制作;与上述业务相关的技术咨询、技术服务。（市场主体依法自主选择经营项目,开展经营活动;演出及经纪业务以及依法须经批准的项目,经相关部门批准后依批准的内容开展经营活动;不得从事国家和本市产业政策禁止和限制类项目的经营活动。）
中国电影集团公司	影片及载体的进出口业务（限分支机构经营）。从事对外影片广告业务;承办国内外影片广告业务;影视投资咨询服务;自有房屋出租;设计、制作、代理、广告发布;《中国电影市场》（发行出版许可证有效期至2023年12月31日）。（市场主体依法自主选择经营项目,开展经营活动;依法须经批准的项目,经相关部门批准后依批准的内容开展经营活动;不得从事国家和本市产业政策禁止和限制类项目的经营活动。）
北京夏岩园林文化艺术集团有限公司	组织文化艺术交流活动（演出除外）;园林设计;园林景观建筑;建筑装修装饰工程;货物进出口;代理进出口;技术进出口;销售建筑材料（不从事实体店铺经营）、装饰材料（不从事实体店铺经营）、工艺美术品、非金属制品、金属制品、卫生间用品、灯具（不从事实体店铺经营）、家具（不从事实体店铺经营）。（企业依法自主选择经营项目,开展经营活动;依法须经批准的项目,经相关部门批准后依批准的内容开展经营活动;不得从事本市产业政策禁止和限制类项目的经营活动。）
北京一海呈天文化产业集团有限公司	演出经纪；文艺创作；项目投资；企业策划；会议服务；市场调查；承办展览展示活动；经济贸易咨询；电脑动画设计；计算机技术培训；技术服务；筹备、策划、组织大型庆典、文化节、艺术节、电影节；体育运动项目经营（高危险性运动项目除外）；教育咨询（不含中介）；设计、制作、代理、发布广告；旅游咨询；产品设计；影视策划；电影票、演出票票务代理；影视衍生品的技术开发；销售工艺品、体育用品、文化用品、电子产品、计算机、软件及辅助设备。（1、不得以公开方式募集资金；2、不得公开交易证券类产品和金融衍生品；3、不得发放贷款；4、不得向所投资企业以外的其他企业提供担保；5、不得向投资者承诺投资本金不受损失或者承诺最低收益；演出经纪以及企业依法自主选择经营项目，开展经营活动；依法须经批准的项目，经相关部门批准后依批准的内容开展经营活动；不得从事本市产业政策禁止和限制类项目的经营活动。）
中外名人文化产业集团有限公司	文艺创作（不含演出）;图文设计;企业形象策划;编辑服务;翻译服务;信息咨询（不含中介服务）;技术开发、技术咨询、技术培训;会议服务。（市场主体依法自主选择经营项目,开展经营活动;依法须经批准的项目,经相关部门批准后依批准的内容开展经营活动;不得从事国家和本市产业政策禁止和限制类项目的经营活动。）
吉祥三宝文化发展集团有限公司	室内装饰工程设计;城市园林绿化;组织文化艺术交流活动（不含营业性演出）;经济贸易咨询;企业策划;电脑动画设计;承办展览展示活动;婚庆服务;技术开发、技术推广、技术转让;计算机技术培训;旅游信息咨询（中介除外）;工艺美术设计;摄影服务;打字;婚姻介绍（不含涉外婚姻）;会议服务;市场调查;代理、发布广告;销售工艺品、建筑材料、日用品、五金、交电、机械设备、计算机、软件及辅助设备、针、纺织品、花卉;货物进出口。（企业依法自主选择经营项目,开展经营活动;依法须经批准的项目,经相关部门批准后依批准的内容开展经营活动;不得从事本市产业政策禁止和限制类项目的经营活动。）
中康国际旅游文化发展集团有限公司	国内旅游业务；入境旅游业务；旅游信息咨询；公共关系服务；企业管理；经济贸易咨询；组织文化艺术交流活动（不含演出）；设计、制作、代理、发布广告；会议及展览服务；市场调查；翻译服务；摄影服务；文艺创作；技术推广服务；酒店管理。（企业依法自主选择经营项目，开展经营活动；国内旅游业务、入境旅游业务以及依法须经批准的项目，经相关部门批准后依批准的内容开展经营活动；不得从事本市产业政策禁止和限制类项目的经营活动。）
北京中鼎文华文化产业集团有限公司	组织文化艺术交流活动；企业策划；工程和技术研究与试验发展；经济贸易咨询；公共关系服务；技术开发；产品设计；企业管理；物业管理；销售建筑材料、五金交电、化工产品（不含化学危险品）、医疗器械（限I类）、计算机及辅助设备、工艺品、日用品、文具用品、针纺织品、机械设备、服装、鞋帽。（企业依法自主选择经营项目，开展经营活动；依法须经批准的项目，经相关部门批准后依批准的内容开展经营活动；不得从事本市产业政策禁止和限制类项目的经营活动。）
玫瑰里文化集团有限公司	组织文化艺术交流活动（演出、棋牌除外）;婚庆服务;企业形象设计、策划;婚纱设计;销售婚纱;摄影服务;承办展览展示;会议服务。（市场主体依法自主选择经营项目,开展经营活动;依法须经批准的项目,经相关部门批准后依批准的内容开展经营活动;不得从事国家和本市产业政策禁止和限制类项目的经营活动。）
华语大业文化产业集团有限公司	组织文化艺术交流活动（演出除外）；项目投资；投资管理、资产管理；企业管理；技术开发、技术转让、技术咨询、技术服务。（企业依法自主选择经营项目，开展经营活动；依法须经批准的项目，经相关部门批准后依批准的内容开展经营活动；不得从事本市产业政策禁止和限制类项目的经营活动。）
墨兰文化发展集团有限公司	组织文化艺术交流活动（不含演出）;教育咨询（不含中介及办学）;技术开发、技术咨询、技术服务、技术推广、技术转让;经济贸易咨询;计算机系统服务;应用软件服务;数据处理;产品设计;销售工艺品、电子产品、金属材料;技术进出口、货物进出口;承办展览展示;会议服务;公关服务。（企业依法自主选择经营项目,开展经营活动;依法须经批准的项目,经相关部门批准后依批准的内容开展经营活动;不得从事本市产业政策禁止和限制类项目的经营活动。）
力度国际文化传媒集团有限公司	预包装食品销售、含冷藏冷冻食品（食品经营许可证有效期至2023年05月02日）；餐饮服务；组织文化艺术交流活动（不含营业性演出）；技术开发、技术咨询、技术服务；承办展览展示活动；投资管理；资产管理；企业管理；电脑动画设计；文艺创作；设计、制作、代理、发布广告；经济贸易咨询；影视策划。（市场主体依法自主选择经营项目，开展经营活动；餐饮服务以及依法须经批准的项目，经相关部门批准后依批准的内容开展经营活动；不得从事国家和本市产业政策禁止和限制类项目的经营活动。）
北京高尔夫集团公司	赛马、高尔夫球服务、木材加工、服装加工、文化娱乐服务;销售建筑材料、日用百货、服装鞋帽、电子元器件、高尔夫球用品。（依法须经批准的项目,经相关部门批准后依批准的内容开展经营活动。）
钰润集团有限公司	会议服务;组织文化艺术交流活动;承办展览展示活动;经济贸易咨询;设计、制作、代理、发布广告;电脑动画设计;企业策划;婚姻服务（不含涉外婚姻介绍）;市场调查;打字、复印;公共关系服务;技术开发、技术推广、技术转让、技术咨询、技术服务;销售日用品、服装鞋帽、工艺品、办公用品、文化用品、机械设备、电子产品、汽车配件。（企业依法自主选择经营项目,开展经营活动;依法须经批准的项目,经相关部门批准后依批准的内容开展经营活动;不得从事本市产业政策禁止和限制类项目的经营活动。）
沃德财富文化艺术集团有限公司	一般项目:组织文化艺术交流活动;技术服务、技术开发、技术咨询、技术交流、技术转让、技术推广;社会经济咨询服务;数字文化创意内容应用服务;数字创意产品展览展示服务;专业设计服务;广告设计、代理;会议及展览服务;金银制品销售;钟表销售;针纺织品销售;体育用品及器材批发;体育用品及器材零售;互联网销售（除销售需要许可的商品）;非金属矿及制品销售;金属矿石销售;机械设备销售;计算机软硬件及辅助设备批发;计算机软硬件及辅助设备零售;通讯设备销售;工艺美术品及收藏品零售（象牙及其制品除外）;工艺美术品及收藏品批发（象牙及其制品除外）;工艺美术品及礼仪用品销售（象牙及其制品除外）;珠宝首饰回收修理服务;食品销售（仅销售预包装食品）。（除依法须经批准的项目外,凭营业执照依法自主开展经营活动）许可项目:住宿服务。（依法须经批准的项目,经相关部门批准后方可开展经营活动,具体经营项目以相关部门批准文件或许可证件为准）（不得从事国家和本市产业政策禁止和限制类项目的经营活动。）
易影文化传媒集团有限公司	组织文化艺术交流活动（演出除外）;承办展览展示活动;动漫设计;设计、制作、代理、发布广告。（企业依法自主选择经营项目,开展经营活动;依法须经批准的项目,经相关部门批准后依批准的内容开展经营活动;不得从事本市产业政策禁止和限制类项目的经营活动。）
实力互通国际文化发展有限公司	设计、制作、代理发布国内及外商来华广告;组织展览展示活动;组织国内文化艺术交流活动（演出除外）。（市场主体依法自主选择经营项目,开展经营活动;依法须经批准的项目,经相关部门批准后依批准的内容开展经营活动;不得从事国家和本市产业政策禁止和限制类项目的经营活动。）
北京美迅娱乐传媒集团有限公司	制作、发行动画片、电视综艺、专题片;设计、制作、代理、发布广告;影视策划;投资及投资管理;文艺创作。（市场主体依法自主选择经营项目,开展经营活动;依法须经批准的项目,经相关部门批准后依批准的内容开展经营活动;不得从事国家和本市产业政策禁止和限制类项目的经营活动。）
大德传媒股份有限公司	组织文化艺术交流（不含演出）;影视策划;设计、制作、代理、发布广告;经济信息咨询;企业形象策划;会议服务;承办展览展示活动;票务代理;旅游信息咨询;销售日用品、工艺品;国内旅游业务;销售食品;餐饮服务;广播电视节目制作;货物专用运输（冷藏保鲜）（有效期2021年04月19日至2025年04年18日）（市场主体依法自主选择经营项目,开展经营活动;国内旅游业、销售食品、餐饮服务、广播电视节目制作以及依法须经批准的项目,经相关部门批准后依批准的内容开展经营活动;不得从事国家和本市产业政策禁止和限制类项目的经营活动。）
北京海逸风传媒股份有限公司	广播电视节目制作;设计、制作、代理、发布广告;广告信息咨询（不含中介服务）;组织文化艺术交流活动（不含演出）;承办展览展示;会议服务;影视策划;经济信息咨询;技术推广服务;销售机械设备;软件开发。（市场主体依法自主选择经营项目,开展经营活动;广播电视节目制作以及依法须经批准的项目,经相关部门批准后依批准的内容开展经营活动;不得从事国家和本市产业政策禁止和限制类项目的经营活动。）
第一摩码体育文化发展（北京）股份有限公司	一般项目:组织文化艺术交流活动;餐饮管理;体育竞赛组织;体育健康服务;健身休闲活动;台球活动;健康咨询服务（不含诊疗服务）;信息咨询服务（不含许可类信息咨询服务）;日用品销售;工艺美术品及礼仪用品销售（象牙及其制品除外）;技术服务、技术开发、技术咨询、技术交流、技术转让、技术推广。（除依法须经批准的项目外,凭营业执照依法自主开展经营活动）许可项目:洗浴服务;高危险性体育运动（游泳）;食品销售;餐饮服务。（依法须经批准的项目,经相关部门批准后方可开展经营活动,具体经营项目以相关部门批准文件或许可证件为准）（不得从事国家和本市产业政策禁止和限制类项目的经营活动。）
新鲜（北京）娱乐传媒股份有限公司	广播电视节目制作；组织文化艺术交流活动（不含棋牌）；承办展览展示；影视策划；舞美设计；摄影；企业形象设计；企业策划；文艺创作；餐饮管理；舞蹈培训（以上培训不得面向全国招生）；设计、制作、代理、发布广告；货物进出口、技术进出口、代理进出口；销售日用品、化妆品、服装、鞋帽、工艺品、体育用品、电子产品、通讯设备、文具用品、箱包、钟表、家具、家用电器、珠宝首饰。（市场主体依法自主选择经营项目，开展经营活动；广播电视节目制作以及依法须经批准的项目，经相关部门批准后依批准的内容开展经营活动；不得从事国家和本市产业政策禁止和限制类项目的经营活动。）
北京剧角映画文化传媒股份有限公司	电影发行;组织文化艺术交流活动（不含演出）;影视策划;设计、制作、代理、发布广告;计算机系统服务;企业策划;经济贸易咨询;会议及展览服务;技术推广服务;电脑动画设计。（依法须经批准的项目,经相关部门批准后依批准的内容开展经营活动。）
北京合润德堂文化传媒有限责任公司	组织文化艺术交流活动（不含演出）;技术推广服务;设计、制作、代理、发布广告;广告信息咨询;品牌策划;影视策划;营销策划;企业形象策划;展览服务;会议服务;货物进出口;代理进出口;技术进出口。（市场主体依法自主选择经营项目,开展经营活动;依法须经批准的项目,经相关部门批准后依批准的内容开展经营活动;不得从事国家和本市产业政策禁止和限制类项目的经营活动。）
北京快来文化传播集团有限公司	软件开发；基础软件服务；应用软件服务；技术开发；技术咨询；技术转让；技术推广；技术服务；软件服务；数据处理（数据处理中的银行卡中心、PUE值在1.4以上的云计算数据中心除外）；设计、制作、代理、发布广告；组织文化艺术交流活动（不含演出）；影视策划；电脑动画设计；会议服务；企业管理咨询；企业策划；从事互联网文化活动；互联网信息服务；文艺表演；演出经纪。（市场主体依法自主选择经营项目，开展经营活动；从事互联网文化活动、互联网信息服务、文艺表演、演出经纪以及依法须经批准的项目，经相关部门批准后依批准的内容开展经营活动；不得从事国家和本市产业政策禁止和限制类项目的经营活动。）
寰宇文化娱乐有限公司	组织文化艺术交流活动（不含演出）；市场调查；设计、制作、代理、发布广告；承办展览展示活动；电影摄制服务。（市场主体依法自主选择经营项目，开展经营活动；依法须经批准的项目，经相关部门批准后依批准的内容开展经营活动；不得从事国家和本市产业政策禁止和限制类项目的经营活动。）
新梦想足球俱乐部有限公司	体育运动项目经营（高危险性体育项目除外）；足球技术培训（不得面向全国招生）；组织文化艺术交流活动（不含演出）；教育咨询（不含出国留学咨询及中介服务）；体育场馆经营；销售日用品、机械设备、体育用品；技术推广服务；基础软件服务；软件开发；市场调查；经济贸易咨询；设计、制作、代理、发布广告；会议及展览服务；企业策划；影视策划；翻译服务。（企业依法自主选择经营项目，开展经营活动；依法须经批准的项目，经相关部门批准后依批准的内容开展经营活动；不得从事本市产业政策禁止和限制类项目的经营活动。）
中军天信（北京）文化有限公司	组织文化艺术交流活动（不含演出）；销售珠宝首饰。（市场主体依法自主选择经营项目，开展经营活动；依法须经批准的项目，经相关部门批准后依批准的内容开展经营活动；不得从事国家和本市产业政策禁止和限制类项目的经营活动。）
凤仪文化娱乐集团有限公司	电子游艺娱乐;广播电视节目制作;组织文化艺术交流活动（不含演出及棋牌娱乐活动）;教育咨询;承办展览展示;企业形象策划;电脑图文设计、制作;投资咨询、投资管理。（市场主体依法自主选择经营项目,开展经营活动;电子游艺娱乐、广播电视节目制作以及依法须经批准的项目,经相关部门批准后依批准的内容开展经营活动;不得从事国家和本市产业政策禁止和限制类项目的经营活动。）
北京万国天骐体育股份有限公司	体育运动项目经营（不含棋牌）;组织文化艺术交流活动（不含演出）;企业形象策划;经济贸易咨询;会议及展览服务;营销策划;设计、制作、代理、发布广告;销售体育用品、日用品、文具用品、工艺美术品、服装、五金交电、玩具、鞋帽、箱包;体育场馆经营（不含游泳场馆）;体育设施租赁;货物进出口;组织体育赛事;健康管理（须经审批的诊疗活动除外）;健康咨询（须经审批的诊疗活动除外）;出租商业用房;企业管理咨询。（市场主体依法自主选择经营项目,开展经营活动;依法须经批准的项目,经相关部门批准后依批准的内容开展经营活动;不得从事国家和本市产业政策禁止和限制类项目的经营活动。）
中国经济传媒集团有限责任公司	设计、制作、发布、代理国内外各类广告;国内展览、展销服务;信息咨询;企业形象策划;市场调研;组织会议及经贸交流活动;对下属企业进行投资和管理。（企业依法自主选择经营项目,开展经营活动;依法须经批准的项目,经相关部门批准后依批准的内容开展经营活动;不得从事本市产业政策禁止和限制类项目的经营活动。）
圆核经典文化传媒（北京）有限公司	组织文化艺术交流;营销策划;礼仪服务;设计、制作、代理、发布广告;经济信息咨询;承办展览展示;投资咨询;投资管理;文艺创作;票务代理（演出票、门票）;销售文化用品;文艺表演;演出经纪。（市场主体依法自主选择经营项目,开展经营活动;“1、未经有关部门批准,不得以公开方式募集资金;2、不得公开开展证券类产品和金融衍生品交易活动;3、不得发放贷款;4、不得对所投资企业以外的其他企业提供担保;5、不得向投资者承诺投资本金不受损失或者承诺最低收益”;市场主体依法自主选择经营项目,开展经营活动;文艺表演以及依法须经批准的项目,经相关部门批准后依批准的内容开展经营活动;不得从事国家和本市产业政策禁止和限制类项目的经营活动。）
中影电影数字制作基地有限公司	许可项目:广播电视节目制作经营;网络文化经营;餐饮服务（不产生油烟、异味、废气）;食品销售;道路货物运输（不含危险货物）。（依法须经批准的项目,经相关部门批准后方可开展经营活动,具体经营项目以相关部门批准文件或许可证件为准）一般项目:租赁服务（不含许可类租赁服务）;文化用品设备出租;影视美术道具置景服务;租借道具活动;数字内容制作服务（不含出版发行）;软件开发;旅游开发项目策划咨询;会议及展览服务;玩具、动漫及游艺用品销售;动漫游戏开发;广播影视设备销售;信息系统集成服务;信息技术咨询服务;教育咨询服务（不含涉许可审批的教育培训活动）;企业形象策划;个人商务服务;广告制作;广告发布;平面设计;非居住房地产租赁;组织文化艺术交流活动;专业设计服务;文艺创作;市场营销策划;电影制片;翻译服务;游览景区管理;日用百货销售;工艺美术品及收藏品零售（象牙及其制品除外）;食用农产品零售;互联网销售（除销售需要许可的商品）;文具用品零售;玩具销售;服装服饰零售;剧本娱乐活动;游乐园服务。（除依法须经批准的项目外,凭营业执照依法自主开展经营活动）（不得从事国家和本市产业政策禁止和限制类项目的经营活动。）
中海盛林生态产业集团有限公司	一般项目:城市绿化管理;企业管理;规划设计管理;工程管理服务;自然生态系统保护管理;水资源管理;生态保护区管理服务;生态恢复及生态保护服务;林业产品销售;农副产品销售;木材加工;木材收购;木材销售;肥料销售;化肥销售;生物有机肥料研发;技术服务、技术开发、技术咨询、技术交流、技术转让、技术推广;体育健康服务;健康咨询服务（不含诊疗服务）;护理机构服务（不含医疗服务）;餐饮管理;酒店管理;物业管理;信息咨询服务（不含许可类信息咨询服务）;旅游开发项目策划咨询;专业设计服务;供应链管理服务;国内贸易代理;体育用品及器材零售;体育用品及器材批发;文具用品批发;机械设备销售;机械设备研发;机械设备租赁;电子、机械设备维护（不含特种设备）;工艺美术品及礼仪用品销售（象牙及其制品除外）;珠宝首饰批发;保健食品（预包装）销售;建筑材料销售;家具销售;家具安装和维修服务;金属制品销售;金属矿石销售;非金属矿及制品销售;互联网销售（除销售需要许可的商品）;货物进出口;技术进出口;进出口代理;食品销售（仅销售预包装食品）;花卉绿植租借与代管理;人工造林;森林经营和管护;花卉种植;农作物栽培服务;农业专业及辅助性活动。（除依法须经批准的项目外,凭营业执照依法自主开展经营活动）许可项目:食品销售;林木种子生产经营;农作物种子经营。（依法须经批准的项目,经相关部门批准后方可开展经营活动,具体经营项目以相关部门批准文件或许可证件为准）（不得从事国家和本市产业政策禁止和限制类项目的经营活动。）
北京未来科学城产业发展有限公司	组织文化艺术交流活动（不含演出）;从事房地产经纪业务;出租商业用房、办公用房;技术推广服务;承办展览展示活动;科技企业孵化;物业管理;销售计算机、软件及辅助设备、文化用品、电子产品;软件开发;基础软件服务、应用软件服务（不含医用软件）;计算机系统服务。（市场主体依法自主选择经营项目,开展经营活动;依法须经批准的项目,经相关部门批准后依批准的内容开展经营活动;不得从事国家和本市产业政策禁止和限制类项目的经营活动。）
北京小马奔腾文化传媒股份有限公司	制作、发行动画片、专题片、电视综艺，不得制作时政新闻及同类专题、专栏等广播电视节目（广播电视节目及电视剧制作许可证有效期至2017年07月27日）；影视策划；设计、制作、代理、发布广告；组织文化艺术交流活动（不含演出）；会议服务；信息咨询（除中介外）；承办展览展示活动；技术开发、技术服务。（市场主体依法自主选择经营项目，开展经营活动；依法须经批准的项目，经相关部门批准后依批准的内容开展经营活动；不得从事国家和本市产业政策禁止和限制类项目的经营活动。）
北京百纳京华文化传媒有限公司	一般项目:组织文化艺术交流活动;广告发布;广告设计、代理;广告制作;平面设计;社会经济咨询服务;贸易经纪;会议及展览服务;办公用品销售;互联网销售（除销售需要许可的商品）;电子产品销售;体育用品及器材零售;工艺美术品及收藏品零售（象牙及其制品除外）;日用百货销售;玩具、动漫及游艺用品销售;化妆品零售;珠宝首饰零售;服装服饰零售;鞋帽零售;日用家电零售;纸制品销售;专业设计服务;包装服务;票务代理服务;人力资源服务（不含职业中介活动、劳务派遣服务）;食品销售（仅销售预包装食品）;旅游开发项目策划咨询;咨询策划服务;市场营销策划;体验式拓展活动及策划;农村民间工艺及制品、休闲农业和乡村旅游资源的开发经营;游览景区管理;休闲观光活动;城市公园管理;商业综合体管理服务;文艺创作;数字文化创意内容应用服务;数字内容制作服务（不含出版发行）。（除依法须经批准的项目外,凭营业执照依法自主开展经营活动）许可项目:游艺娱乐活动;演出经纪;广播电视节目制作经营;电视剧制作;出版物零售。（依法须经批准的项目,经相关部门批准后方可开展经营活动,具体经营项目以相关部门批准文件或许可证件为准）（不得从事国家和本市产业政策禁止和限制类项目的经营活动。）
北京中文发文化发展有限公司	组织文化艺术交流活动（演出除外）;计算机技术开发、技术转让、技术咨询;计算机技术培训;舞台灯光音响设备安装、设计。（市场主体依法自主选择经营项目,开展经营活动;该企业于2007年10月30日前为内资企业于2007年10月30日后变更为外商投资企业。;依法须经批准的项目,经相关部门批准后依批准的内容开展经营活动;不得从事国家和本市产业政策禁止和限制类项目的经营活动。）
山水盛典文化产业股份有限公司	经营演出及经纪业务;组织文化艺术交流活动;文化艺术咨询;声乐舞蹈培训（不得面向全国招生）;文化艺术投资;舞台艺术创作服务;动漫及衍生品设计服务;舞台表演宣传、组织、辅助服务;服装设计、制作;旅游工艺品设计;旅游资源开发（不含旅游业务）;广告设计、制作、代理、发布;会议服务;承办展览展示;旅游信息咨询;景区门票票务代理;出租商业用房;出租办公用房;销售工艺品;技术开发、技术转让、技术咨询、技术服务;货物进出口、技术进出口、代理进出口。（市场主体依法自主选择经营项目,开展经营活动;经营演出及经纪业务以及依法须经批准的项目,经相关部门批准后依批准的内容开展经营活动;不得从事国家和本市产业政策禁止和限制类项目的经营活动。）
华锦文化发展有限公司	组织文化艺术交流活动（不含演出）;演出经纪;广播电视节目制作。（市场主体依法自主选择经营项目,开展经营活动;演出经纪、广播电视节目制作以及依法须经批准的项目,经相关部门批准后依批准的内容开展经营活动;不得从事国家和本市产业政策禁止和限制类项目的经营活动。）
京华文化传播有限公司	第二类增值电信业务中的信息服务业务（仅限互联网信息服务）;互联网信息服务不含出版、教育、医疗保健、药品和医疗器械,含新闻、电子公告服务（电信与信息服务业务经营许可证有效期至2018年04月07日）;批发预包装食品（食品流通许可证有效期至2016年08月27日）;图书、报纸、期刊、电子出版物批发、零售、网上销售（出版物经营许可证有效期至2022年04月30日）;组织文化体育交流活动（演出除外）;承办展览展示活动;信息咨询（中介除外）;销售新鲜水果、新鲜蔬菜、日用百货、计算机及外围设备、建筑材料、金属材料、机械电器设备、五金、化工、交电;技术开发、技术转让、技术咨询、技术服务、技术培训;设计、制作、代理、发布国内及外商来华广告;回收废旧报纸、图书、纸张。（依法须经批准的项目,经相关部门审批后方可开展经营活动）（企业依法自主选择经营项目,开展经营活动;依法须经批准的项目,经相关部门批准后依批准的内容开展经营活动;不得从事本市产业政策禁止和限制类项目的经营活动。）
中演演出院线发展有限责任公司	经营演出及经纪业务;剧场经营管理;剧场出租;组织文化艺术交流;承办展览展示;艺术培训;物业管理;投资顾问;企业管理策划;设计、制作、代理、发布广告;信息咨询（不含中介服务）;市场调查;销售百货、工艺美术品。（“1、未经有关部门批准,不得以公开方式募集资金;2、不得公开开展证券类产品和金融衍生品交易活动;3、不得发放贷款;4、不得对所投资企业以外的其他企业提供担保;5、不得向投资者承诺投资本金不受损失或者承诺最低收益”;企业依法自主选择经营项目,开展经营活动;依法须经批准的项目,经相关部门批准后依批准的内容开展经营活动;不得从事本市产业政策禁止和限制类项目的经营活动。）
北京金色池塘传媒股份有限公司	广播电视节目制作；影视文化艺术策划；美术设计、制作；组织展览展销；影视音像设备租赁；家庭装饰；劳务服务；信息咨询（中介服务除外）；从事文化经纪业务；设计、制作、代理、发布广告；出租办公用房。（市场主体依法自主选择经营项目，开展经营活动；广播电视节目制作以及依法须经批准的项目，经相关部门批准后依批准的内容开展经营活动；不得从事国家和本市产业政策禁止和限制类项目的经营活动。）
中国大百科全书出版社有限公司	许可项目：图书出版；出版物零售；出版物批发；出版物互联网销售；网络出版物出版；电子出版物出版；期刊出版；音像制品出版；电子出版物制作。（依法须经批准的项目，经相关部门批准后方可开展经营活动，具体经营项目以相关部门批准文件或许可证件为准）一般项目：图书管理服务；数字内容制作服务（不含出版发行）；文具用品零售；会议及展览服务；数字文化创意内容应用服务；数字文化创意技术装备销售；国内贸易代理；工艺美术品及礼仪用品销售（象牙及其制品除外）；服务消费机器人销售；智能机器人的研发；版权代理；信息系统集成服务；互联网销售（除销售需要许可的商品）；互联网设备销售；数字技术服务；网络设备销售；软件开发；互联网数据服务；人工智能应用软件开发；食品互联网销售（仅销售预包装食品）；网络与信息安全软件开发；互联网安全服务；信息咨询服务（不含许可类信息咨询服务）；数据处理和存储支持服务；数据处理服务；组织文化艺术交流活动；信息技术咨询服务；广告制作；广告设计、代理；广告发布；平面设计；电子产品销售；智能机器人销售；日用品销售；日用百货销售；办公用品销售；体育用品及器材零售；物业管理；建筑材料销售；鞋帽零售；食品销售（仅销售预包装食品）；保健食品（预包装）销售；软件销售；数字文化创意软件开发；人工智能基础软件开发；技术服务、技术开发、技术咨询、技术交流、技术转让、技术推广。（除依法须经批准的项目外，凭营业执照依法自主开展经营活动）（不得从事国家和本市产业政策禁止和限制类项目的经营活动。）
北京华锐光年文化发展有限公司	组织文化艺术交流活动（不含演出）；体育运动项目经营（高危险性运动项目除外）；经济贸易咨询；会议服务；承办展览展示活动；设计、制作、代理、发布广告；项目投资；投资管理；资产管理；销售体育用品。（该企业2021年12月16日前为内资企业，于2021年12月16日变更为外商投资企业；市场主体依法自主选择经营项目，开展经营活动；依法须经批准的项目，经相关部门批准后依批准的内容开展经营活动；不得从事国家和本市产业政策禁止和限制类项目的经营活动。）
永新华韵文化产业有限公司	组织文化艺术交流;筹备、策划、组织大型庆典;电脑动画设计;文艺创作;企业管理;承办展览展示;会议服务;技术推广服务;商标代理;版权贸易;设计、制作、代理、发布广告;健康管理（须经审批的诊疗活动除外）;健康咨询（须经审批的诊疗活动除外）;餐饮管理;货物进出口;技术进出口;代理进出口;销售文化用品、体育用品、针纺织品、服装、鞋帽、日用品、玩具、珠宝首饰、工艺品、黄金制品、白银制品;文艺表演;销售食品。（企业依法自主选择经营项目,开展经营活动;文艺表演、销售食品以及依法须经批准的项目,经相关部门批准后依批准的内容开展经营活动;不得从事本市产业政策禁止和限制类项目的经营活动。）
大唐辉煌传媒有限公司	制作、发行动画片、专题片、电视综艺,不得制作时政新闻及同类专题、专栏等广播电视节目;影视投资管理;组织文化艺术交流活动;企业形象策划;设计、制作、代理、发布广告。（市场主体依法自主选择经营项目,开展经营活动;依法须经批准的项目,经相关部门批准后依批准的内容开展经营活动;不得从事国家和本市产业政策禁止和限制类项目的经营活动。）
中国铁路文工团有限公司	演出场所经营;演出经纪;文艺表演;电影发行;电影放映;专业承包;广播电视节目制作;电影摄制;出版物零售;销售食品;餐饮服务;文艺创作;销售文化用品、工艺品、花卉;影视策划;文艺演出票务代理;声乐培训;舞蹈培训;组织文化艺术交流活动（不含演出）;机械设备租赁;设计、制作、代理、发布广告;会议服务;承办展览展示;机动车公共停车场服务。（市场主体依法自主选择经营项目,开展经营活动;演出场所经营、演出经纪、文艺表演、电影发行、广播电视节目制作、电影摄制、电影放映、出版物零售、销售食品、餐饮服务以及依法须经批准的项目,经相关部门批准后依批准的内容开展经营活动;不得从事国家和本市产业政策禁止和限制类项目的经营活动。）
世欣东方（北京）文化集团有限公司	一般项目:组织文化艺术交流活动;物业管理;会议及展览服务;仓储设备租赁服务;企业管理咨询;教育咨询服务（不含涉许可审批的教育培训活动）;社会经济咨询服务;信息咨询服务（不含许可类信息咨询服务）;图文设计制作;广告发布;广告设计、代理;广告制作;技术服务、技术开发、技术咨询、技术交流、技术转让、技术推广;非居住房地产租赁;停车场服务。（除依法须经批准的项目外,凭营业执照依法自主开展经营活动）（不得从事国家和本市产业政策禁止和限制类项目的经营活动。）
党建读物出版社有限公司	出版新时期党建理论研究著作、党建工作经验、中央和地方党组织有关党建的文献以及党员教材（有效期至2029年12月31日）。（市场主体依法自主选择经营项目,开展经营活动;依法须经批准的项目,经相关部门批准后依批准的内容开展经营活动;不得从事国家和本市产业政策禁止和限制类项目的经营活动。）
海润影视制作有限公司	电视剧制作;影视策划;影视咨询;组织文化艺术交流活动（演出除外）;设备租赁（不含汽车）;投资管理;承办展览展示活动;会议服务;设计、制作、代理、发布广告;图文设计及制作、美术设计及制作;企业形象设计;接受委托进行市场调查;提供信息源服务;网络技术服务;信息咨询（中介除外）、技术开发、技术咨询、技术培训、技术服务;销售影视设备、器材、日用百货、工艺美术品、办公用品、电子计算机、五金交电、机械设备、家用电器、仪器仪表、汽车配件。（市场主体依法自主选择经营项目,开展经营活动;电视剧制作以及依法须经批准的项目,经相关部门批准后依批准的内容开展经营活动;不得从事国家和本市产业政策禁止和限制类项目的经营活动。）
定军山影业有限公司	电影摄制;电影发行;广播电视节目制作;演出经纪;文艺表演;销售食品;组织国内文化艺术交流;广告设计、制作、代理、发布;礼仪服务;货物进出口、技术进出口（以上两项不含法律法规规定需要审批的项目）、代理进出口;会议服务;承办展览展示;影视信息咨询;庆典活动策划;投资管理;影视策划;剧本创作服务;电脑动画设计租赁影视器材、服装、道具;技术开发、技术转让、技术培训、技术咨询;商业信息咨询（中介服务除外）;彩扩、冲印像片服务;企业形象策划;计算机图文设计;家居装饰;销售建筑材料、木材、计算机及外围设备、五金、交电、化工（化学危险品及一类易制毒化学品除外）、百货、针纺织品、办公设备、金属材料（涉及专项审批的项目除外）。（企业依法自主选择经营项目,开展经营活动;电影摄制;电影发行;广播电视节目制作;演出经纪;文艺表演;销售食品依法须经批准的项目,经相关部门批准后依批准的内容开展经营活动;不得从事本市产业政策禁止和限制类项目的经营活动。）
中农惠民天汇集团有限公司	文化咨询;公关关系服务;会议服务;工艺美术设计;电脑动画设计;企业策划;设计、制作、代理、发布广告;市场调查;企业管理咨询;组织文化艺术交流活动（不含营业性演出）;文艺创作;承办展览展示活动;会议服务;影视策划;翻译服务;技术开发、技术推广、技术转让、技术咨询、技术服务;计算机系统服务;基础软件服务、应用软件服务;软件开发;软件咨询;产品设计;模型设计;包装装潢设计;经济贸易咨询;数据处理（数据处理中的银行卡中心、PUE值在1.5以上的云计算机数据中心除外）;接受金融机构委托从事金融信息技术外包服务;接受金融机构委托从事金融业务流程外包服务;接受金融机构委托从事金融知识流程外包服务;餐饮管理;酒店管理;销售金属制品、煤炭（不得在北京地区开展实物煤的交易、储运活动）、建筑材料、五金交电、机械设备、化工产品（不含危险化学品）;土壤污染治理与修复服务;土壤环境污染防治服务;环境保护监测;大气环境污染防治服务;大气污染治理;气象观测服务;工程和技术研究和试验发展。（市场主体依法自主选择经营项目,开展经营活动;依法须经批准的项目,经相关部门批准后依批准的内容开展经营活动;不得从事国家和本市产业政策禁止和限制类项目的经营活动。）
北京电影制片厂	影视投资；自有房屋出租。（依法须经批准的项目，经相关部门批准后方可开展经营活动）（企业依法自主选择经营项目，开展经营活动；依法须经批准的项目，经相关部门批准后依批准的内容开展经营活动；不得从事本市产业政策禁止和限制类项目的经营活动。）
中国日报社	编辑、出版、发行《中国日报》、《商业周刊》、《北京周末》、《上海星报》、《The21st  Century（21世纪英文报）;承办自办报纸的国内和外商来华广告业务;为社会提供翻译、印刷,信息服务;组织公关活动、技术、文化交流和文艺活动;组织新闻、信息发布、讲座、辅导、函授、培训活动;提供摄影、洗印、饮食服务;自有房产的出租;设备、汽车的维修;与主兼营业务相关的咨询、服务。（依法须经批准的项目,经相关部门批准后依批准的内容开展经营活动。）
北京腾踔文化传媒有限公司	组织文化艺术交流活动;影视策划;票务代理;企业策划;电脑图文设计;舞台灯光音响设计;承办展览展示活动;会议服务;经济贸易咨询;从事文化经纪业务;企业管理咨询;技术推广服务;计算机技术培训（不面向全国招生）;设计、制作、代理、发布广告;销售计算机、软件及辅助设备、通讯设备、文具用品、电子产品、机械设备、服装、鞋帽、日用品、体育用品、珠宝首饰、音响设备、工艺品、家用电器、厨房用具、花卉、新鲜水果;租赁服装、针纺织品;文艺表演;互联网信息服务;演出经纪。（市场主体依法自主选择经营项目,开展经营活动;互联网信息服务、互联网信息服务、文艺表演、演出经纪以及依法须经批准的项目,经相关部门批准后依批准的内容开展经营活动;不得从事国家和本市产业政策禁止和限制类项目的经营活动。）
玖零互生文化发展（北京）股份有限公司	组织文化艺术交流活动（不含演出）;企业管理咨询;企业形象策划;承办展览展示活动;经济贸易咨询;设计、制作、代理、发布广告;技术开发;销售电子产品、工艺品、文具用品;会议服务;营销策划;出版物批发;出版物零售。（市场主体依法自主选择经营项目,开展经营活动;出版物批发、出版物零售以及依法须经批准的项目,经相关部门批准后依批准的内容开展经营活动;不得从事国家和本市产业政策禁止和限制类项目的经营活动。）
广州万达国际电影城有限公司	玩具销售;工艺美术品及收藏品零售（象牙及其制品除外）;服装服饰零售;日用品销售;日用口罩（非医用）销售;医用口罩零售;外卖递送服务;娱乐性展览;会议及展览服务;组织文化艺术交流活动;广告设计、代理;广告制作;广告发布（非广播电台、电视台、报刊出版单位）;非居住房地产租赁;票务代理服务;食用农产品零售;电影放映;餐饮服务;小餐饮、小食杂、食品小作坊经营;食品经营（销售散装食品）;酒类经营;食品经营;食品互联网销售
广东品拓会文化传播集团有限公司	咨询策划服务;旅游开发项目策划咨询;体验式拓展活动及策划;企业管理咨询;票据信息咨询服务;采购代理服务;品牌管理;政府采购代理服务;项目策划与公关服务;个人商务服务;票务代理服务;旅行社服务网点旅游招徕、咨询服务;会议及展览服务;广告设计、代理;体育赛事策划;企业形象策划;市场营销策划;信息咨询服务（不含许可类信息咨询服务）;供应链管理服务;水产品零售;化妆品零售;鞋帽零售;服装服饰零售;日用百货销售;鞋帽批发;服装服饰批发;食用农产品批发;食品互联网销售（仅销售预包装食品）;农副产品销售;水产品批发;谷物销售;食品进出口;娱乐性展览;组织文化艺术交流活动;其他文化艺术经纪代理;文化娱乐经纪人服务;组织体育表演活动;个人互联网直播服务（需备案）;文艺创作
爱柏体育赛事有限公司	体育运动咨询服务;体育营销策划服务;体育组织;竞技体育科技服务;大型活动组织策划服务（大型活动指晚会、运动会、庆典、艺术和模特大赛、艺术节、电影节及公益演出、展览等，需专项审批的活动应在取得审批后方可经营）;广告业;汽车零配件批发;汽车零配件零售;摩托车零配件零售;商品批发贸易（许可审批类商品除外）;商品零售贸易（许可审批类商品除外）;技术进出口;货物进出口（专营专控商品除外）
广州欣卓文化集团股份有限公司	教育咨询服务;策划创意服务;企业形象策划服务;舞台表演艺术指导服务;乐器批发;体育用品及器材批发;乐器零售;文具用品零售;文具用品批发;文化艺术咨询服务;其他文化娱乐用品批发;体育用品及器材零售;大型活动组织策划服务（大型活动指晚会、运动会、庆典、艺术和模特大赛、艺术节、电影节及公益演出、展览等,需专项审批的活动应在取得审批后方可经营）;企业管理咨询服务
广州巴伽娱乐传媒有限公司	影视经纪代理服务;音像经纪代理服务;企业管理咨询服务;市场营销策划服务;策划创意服务;广告业;企业形象策划服务;会议及展览服务;文化艺术咨询服务;大型活动组织策划服务（大型活动指晚会、运动会、庆典、艺术和模特大赛、艺术节、电影节及公益演出、展览等,需专项审批的活动应在取得审批后方可经营）;多媒体设计服务;舞台表演艺术指导服务;艺术表演场馆管理服务;文化研究;群众参与的文艺类演出、比赛等公益性文化活动的策划;其他文化娱乐用品批发;舞台表演美工服务;舞台表演化妆服务;商品批发贸易（许可审批类商品除外）;商品零售贸易（许可审批类商品除外）
九星众盟文化发展有限公司	计算机网络系统工程服务;网络信息技术推广服务;计算机技术开发、技术服务;软件开发;互联网区块链技术研究开发服务;农业技术咨询、交流服务;网络技术的研究、开发;企业形象策划服务;大型活动组织策划服务（大型活动指晚会、运动会、庆典、艺术和模特大赛、艺术节、电影节及公益演出、展览等,需专项审批的活动应在取得审批后方可经营）;酒店管理;物业管理;汽车租赁;货物进出口（专营专控商品除外）;广告业;文化艺术咨询服务;群众参与的文艺类演出、比赛等公益性文化活动的策划;文化推广（不含许可经营项目）;文化传播（不含许可经营项目）;商品信息咨询服务;市场调研服务;信息技术咨询服务;投资咨询服务;会议及展览服务;票务服务;企业管理咨询服务;企业自有资金投资;项目投资（不含许可经营项目,法律法规禁止经营的项目不得经营）;商品批发贸易（许可审批类商品除外）;互联网商品销售（许可审批类商品除外）;化妆品及卫生用品批发;化妆品批发;化妆品及卫生用品零售;化妆品零售;互联网商品零售（许可审批类商品除外）;食品添加剂批发;食品添加剂零售;食品科学技术研究服务;医疗用品及器材零售（不含药品及医疗器械）;心理咨询服务（不含医学心理咨询、医学心理训练、医学心理辅导等医疗行为）;生物医疗技术研究;医疗技术推广服务;医疗技术咨询、交流服务;医疗技术转让服务;亚健康调理（不含医疗服务,不含许可经营项目,法律法规禁止经营的项目不得经营）;营养健康咨询服务;非许可类医疗器械经营;预包装食品批发;网络销售预包装食品;保健食品批发（具体经营项目以《食品经营许可证》为准）;散装食品批发;预包装食品零售;保健食品零售（具体经营项目以《食品经营许可证》为准）;散装食品零售;食品经营管理;许可类医疗器械经营;医疗诊断、监护及治疗设备零售;提供医疗器械贮存配送服务
广东名雅实业发展有限公司	技术服务、技术开发、技术咨询、技术交流、技术转让、技术推广;广告发布（非广播电台、电视台、报刊出版单位）;广告设计、代理;广告制作;市场营销策划;企业管理咨询;会议及展览服务;金属制日用品制造
广州市大导之演文化传播有限公司	群众参与的文艺类演出、比赛等公益性文化活动的策划;策划创意服务;企业形象策划服务;广告业;大型活动组织策划服务（大型活动指晚会、运动会、庆典、艺术和模特大赛、艺术节、电影节及公益演出、展览等，需专项审批的活动应在取得审批后方可经营）;公共关系服务;商品信息咨询服务;文化艺术咨询服务;市场营销策划服务;企业管理咨询服务;其他文化娱乐用品批发;化妆品及卫生用品批发;文具用品批发;文艺创作服务;市场调研服务;文化娱乐经纪人;影视经纪代理服务;投资咨询服务;民宿服务
广州一生国学文化传播有限公司	文化传播（不含许可经营项目）;文化艺术咨询服务;文化研究;文化推广（不含许可经营项目）;群众参与的文艺类演出、比赛等公益性文化活动的策划;文化娱乐经纪人;其他文化娱乐用品批发;国学文化推广服务;国学教育咨询服务;职业技能培训（不包括需要取得许可审批方可经营的职业技能培训项目）;体育培训;企业总部管理;企业管理服务（涉及许可经营项目的除外）;企业管理咨询服务;企业形象策划服务;企业财务咨询服务;美术辅导服务;工艺美术辅导服务;表演艺术辅导服务;家庭服务;个人投币机器服务;婚姻服务;软件技术推广服务;网络信息技术推广服务;公司礼仪服务;模特服务;个人形象设计服务;大型活动组织策划服务（大型活动指晚会、运动会、庆典、艺术和模特大赛、艺术节、电影节及公益演出、展览等,需专项审批的活动应在取得审批后方可经营）;市场营销策划服务;政府采购咨询服务;公共关系服务;策划创意服务;市场调研服务;营养健康咨询服务;教育咨询服务;体育运动咨询服务;工商咨询服务;工商登记代理服务;招、投标咨询服务;体育营销策划服务;母婴月子生活咨询服务;婴幼儿启蒙咨询服务;办公服务;文艺创作服务;雕刻艺术创作服务;绘画艺术创作服务;书法篆刻创作服务;艺（美）术创作服务;档案管理技术服务;收藏品的修复、养护服务;艺（美）术品、收藏品鉴定、咨询服务;珠宝鉴定服务;档案管理服务;金属结构件设计服务;标识、标志牌设计、安装服务;电子产品设计服务;美术图案设计服务;珠宝首饰设计服务;动漫及衍生产品设计服务;饰物装饰设计服务;展台设计服务;体育、休闲娱乐工程设计服务;珠宝玉石检测服务;金属工艺品制造;漆器工艺品制造;花画工艺品制造;天然植物纤维编织工艺品制造;抽纱刺绣工艺品制造;玻璃工艺品制造;刺绣工艺品制造;雕塑工艺品制造（象牙及其制品除外）;民间工艺品制造（象牙及其制品除外）;工艺品批发（象牙及其制品除外）;工艺美术品零售（象牙及其制品除外）;收购古旧书籍、碑帖、拓本、字画等工艺美术品（文物除外,法律禁止经营的不得经营,涉及许可证的凭许可证经营）;珠宝首饰及有关物品制造;水晶首饰批发;钻石首饰零售
时代传奇管理咨询（广东）有限公司	咨询策划服务;项目策划与公关服务;企业形象策划;市场营销策划;文艺创作;礼仪服务;平面设计;专业设计服务;会议及展览服务;组织文化艺术交流活动;其他文化艺术经纪代理;文化娱乐经纪人服务;电影摄制服务;体育用品及器材零售;通讯设备销售;计算机及通讯设备租赁;化妆品零售;珠宝首饰零售;珠宝首饰批发;宠物食品及用品零售;电子产品销售;箱包销售;皮革销售;皮革制品销售;服装服饰零售;食用农产品零售;新鲜水果零售;汽车装饰用品销售;母婴用品销售;日用百货销售;家具零配件销售;日用品销售;卫生用品和一次性使用医疗用品销售;娱乐性展览;工艺美术品及收藏品零售（象牙及其制品除外）;工艺美术品及收藏品批发（象牙及其制品除外）;摄像及视频制作服务;数字内容制作服务（不含出版发行）;鞋帽零售;鞋帽批发;个人商务服务;广告设计、代理;办公设备销售;文具用品零售;文具用品批发;玩具销售;广告发布;互联网销售（除销售需要许可的商品）;广播电视节目制作经营;演出经纪;网络文化经营;音像制品制作;出版物互联网销售;出版物批发;出版物零售;食品销售
广州聚星文化传媒有限公司	电影摄制服务;其他文化艺术经纪代理;信息咨询服务（不含许可类信息咨询服务）;组织文化艺术交流活动;文艺创作;广告发布（非广播电台、电视台、报刊出版单位）;文化娱乐经纪人服务;化妆品批发;钟表销售;箱包销售;乐器批发;母婴用品销售;皮革制品销售;日用木制品销售;鞋帽批发;纸制品销售;眼镜销售（不含隐形眼镜）;家居用品销售;日用品批发;食品添加剂销售;服装服饰批发;个人卫生用品销售;文具用品批发;灯具销售;日用百货销售;卫生用品和一次性使用医疗用品销售;珠宝首饰批发;金银制品销售;厨具卫具及日用杂品批发;厨具卫具及日用杂品零售;住房租赁;普通货物仓储服务（不含危险化学品等需许可审批的项目）;粮油仓储服务;汽车新车销售;汽车旧车销售;珠宝首饰零售;化妆品零售;信息技术咨询服务;企业形象策划;咨询策划服务;服装服饰零售;家用电器销售;网络技术服务;日用品销售;国内货物运输代理;技术服务、技术开发、技术咨询、技术交流、技术转让、技术推广;鞋帽零售;家具销售;企业管理咨询;非居住房地产租赁;互联网销售（除销售需要许可的商品）;五金产品零售;日用玻璃制品销售;软件开发;塑料制品销售;皮革销售;乐器零售;玩具销售;演出经纪;信息网络传播视听节目;音像制品制作;食品经营;食品经营（销售散装食品）;互联网直播服务（不含新闻信息服务、网络表演、网络视听节目）;互联网信息服务
广州瓜瓜传媒有限公司	帽零售;鞋零售;头饰零售;服装零售;商品零售贸易（许可审批类商品除外）;百货零售（食品零售除外）;日用杂品综合零售;水果零售;干果、坚果零售;化妆品及卫生用品零售;婴儿用品零售;宝石饰品零售;电子产品零售;商品批发贸易（许可审批类商品除外）;货物进出口（专营专控商品除外）;技术进出口;水果批发;干果、坚果批发;服装批发;头饰批发;鞋批发;帽批发;化妆品及卫生用品批发;厨房设备及厨房用品批发;卫生盥洗设备及用具批发;日用器皿及日用杂货批发;钟表批发;箱、包批发;婴儿用品批发;宝石饰品批发;玩具批发;电子产品批发;互联网商品销售（许可审批类商品除外）;工艺品批发（象牙及其制品除外）;文化娱乐经纪人;影视经纪代理服务;音像经纪代理服务;文学、艺（美）术经纪代理服务;美术展览经纪代理服务;艺术表演场馆管理服务;舞台表演艺术指导服务;舞台表演安全保护服务;舞台表演美工服务;舞台表演道具服务;舞台表演化妆服务;企业形象策划服务;策划创意服务;市场营销策划服务;包装服务;个人形象设计服务;会议及展览服务;文化传播（不含许可经营项目）;广告业;网络信息技术推广服务;文化推广（不含许可经营项目）;信息技术咨询服务;文化艺术咨询服务;商品信息咨询服务;电影和影视节目制作;音像制品制作;录音制作;预包装食品零售;演出经纪代理服务
广州南湖高尔夫俱乐部有限公司	高尔夫球练习场;快餐服务
广东雪蕾香氛文化有限公司	化妆品零售;第一类医疗器械销售;第一类医疗器械生产;日用化学产品销售;网络技术服务;劳动保护用品生产;日用化学产品制造;劳动保护用品销售;包装材料及制品销售;文化场馆管理服务;化妆品批发;信息技术咨询服务;机械设备租赁;橡胶制品销售;物业管理;非居住房地产租赁;租赁服务（不含许可类租赁服务）
广东战狼电影集团有限公司	文化传播（不含许可经营项目）;茶叶作物及饮料作物批发;交通运输咨询服务;信息技术咨询服务;货物进出口（专营专控商品除外）;电子商务信息咨询;商品批发贸易（许可审批类商品除外）;互联网商品销售（许可审批类商品除外）;互联网商品零售（许可审批类商品除外）;投资咨询服务;商品零售贸易（许可审批类商品除外）;文化艺术咨询服务;群众参与的文艺类演出、比赛等公益性文化活动的策划;美容健身咨询服务;教育咨询服务;服装批发;服装零售;贸易咨询服务;企业管理咨询服务;营养健康咨询服务;商品信息咨询服务;健康管理咨询服务（须经审批的诊疗活动、心理咨询除外，不含许可经营项目，法律法规禁止经营的项目不得经营）;文化推广（不含许可经营项目）;大型活动组织策划服务（大型活动指晚会、运动会、庆典、艺术和模特大赛、艺术节、电影节及公益演出、展览等，需专项审批的活动应在取得审批后方可经营）;影视经纪代理服务;音像经纪代理服务;文化娱乐经纪人;录音制作;电影放映;电影和影视节目发行;音像制品制作;电影和影视节目制作;赛事转播服务;信息网络传播视听节目业务;付费广播节目播出服务;国外广播节目播出服务;国内广播节目播出服务;广播电视节目制作（具体经营范围以《广播电视节目制作经营许可证》为准）;演出经纪代理服务;网络音乐服务
广州云享文化体育发展有限公司	物业管理;住房租赁;土地使用权租赁;非居住房地产租赁;文化场馆管理服务;其他文化艺术经纪代理;组织文化艺术交流活动;市场营销策划;企业形象策划;体育赛事策划;职工疗休养策划服务;体验式拓展活动及策划;咨询策划服务;项目策划与公关服务;体育竞赛组织;体育用品制造;体育中介代理服务;体育健康服务;组织体育表演活动;体育经纪人服务;体育场地设施工程施工;体育用品及器材零售;体育用品设备出租;体育保障组织;文艺创作;企业管理咨询;旅行社服务网点旅游招徕、咨询服务;信息技术咨询服务;数字文化创意内容应用服务;广告设计、代理;广告制作;广告发布（非广播电台、电视台、报刊出版单位）;文物文化遗址保护服务;文化用品设备出租;文化娱乐经纪人服务;文化、办公用设备制造;文化场馆用智能设备制造;非物质文化遗产保护;打字复印;印刷专用设备制造;食品经营（仅销售预包装食品）;停车场服务;会议及展览服务;餐饮管理;城市公园管理;公园、景区小型设施娱乐活动;机动车充电销售;体育场地设施经营（不含高危险性体育运动）;高危险性体育运动（游泳）;射击竞技体育运动;广告发布（广播电台、电视台、报刊出版单位）;网络文化经营;旅游业务;公章刻制;包装装潢印刷品印刷;特定印刷品印刷;文件、资料等其他印刷品印刷;印刷品装订服务
广东华薇文化传播有限公司	游戏软件设计制作;美术展览经纪代理服务;技术进出口;影视经纪代理服务;家具和相关物品修理;互联网商品零售（许可审批类商品除外）;计算机房维护服务;投资咨询服务;舞台表演化妆服务;策划创意服务;网络技术的研究、开发;计算机技术开发、技术服务;软件开发;广告业;公共关系服务;文化艺术咨询服务;婚姻服务;文艺创作服务;生活清洗、消毒服务;室内手工制作娱乐服务;市场营销策划服务;文化推广（不含许可经营项目）;文化传播（不含许可经营项目）;文化娱乐经纪人;会议及展览服务;动漫（动画）经纪代理服务;室内非射击类、非球类、非棋牌类的竞技娱乐活动（不含电子游艺、攀岩、蹦床）;货物进出口（专营专控商品除外）;舞台表演艺术指导服务;家用电子产品修理;贸易咨询服务;企业管理咨询服务;企业形象策划服务;贸易代理;商品信息咨询服务;家庭服务;厨房用具及日用杂品零售;化妆品及卫生用品批发;化妆品及卫生用品零售;非许可类医疗器械经营;医疗设备租赁服务;护理服务（不涉及提供住宿、医疗诊断、治疗及康复服务）;农副食品加工专用设备制造;食品科学技术研究服务;物联网服务;互联网出版业;电子认证;网上图片服务;营业性文艺表演;专业网络平台的构建和运营（法律、行政法规、国务院决定禁止的项目除外，依法须取得许可的项目，须取得许可后方可经营）;网络游戏服务;网上读物服务;食品经营管理;网上动漫服务;电子出版物出版;人事代理;网上新闻服务;网络音乐服务;网上视频服务;网上电影服务;演出经纪代理服务;预包装食品批发;网络销售预包装食品;散装食品批发;预包装食品零售;散装食品零售
广州蚊子动漫科技有限公司	数字动漫制作;电子产品批发;玩具零售;企业形象策划服务;动漫及衍生产品设计服务;软件开发;玩具批发;游戏设计制作;软件服务;软件批发;服装批发;大型活动组织策划服务;服装零售
广州星逸文化有限公司	文艺创作服务;企业总部管理;联系总公司业务;单位后勤管理服务（涉及许可经营的项目除外）;企业管理服务（涉及许可经营项目的除外）;供应链管理;企业管理咨询服务;企业形象策划服务;企业财务咨询服务;专利服务;商标代理等服务;版权服务;软件服务;人力资源外包;业务流程外包;劳务承揽;接受委托从事劳务外包服务;以服务外包方式从事职能管理服务和项目管理服务以及人力资源服务和管理;企业自有资金投资;玩具制造;玩具批发;玩具零售;玩具设计服务;塑料制品批发;木制、塑料、皮革日用品零售;新材料技术推广服务;新材料技术开发服务;新材料技术咨询、交流服务;新材料技术转让服务;日用塑料制品制造;商品批发贸易（许可审批类商品除外）;互联网商品销售（许可审批类商品除外）;商品零售贸易（许可审批类商品除外）;互联网商品零售（许可审批类商品除外）;塑料零件制造
中国唱片（广州）有限公司	家用电器销售;家用电器零配件销售;家用视听设备销售;住房租赁;非居住房地产租赁;广告设计、代理;广告制作;广告发布（非广播电台、电视台、报刊出版单位）;数字内容制作服务（不含出版发行）;业务培训（不含教育培训、职业技能培训等需取得许可的培训）;出版物出版;出版物批发;出版物互联网销售;出版物零售
广州一粒尘埃传媒有限公司	个人互联网直播服务（需备案）;文艺创作;电影摄制服务;渔具销售;食品经营（仅销售预包装食品）;茶具销售;鞋帽零售;服装服饰零售;厨具卫具及日用杂品零售;化妆品零售;珠宝首饰零售;日用家电零售;家具销售;办公用品销售;日用杂品销售;体育用品及器材零售;纸制品销售;藤制品销售;网络设备销售;玩具销售;移动通信设备销售;音响设备销售;照相机及器材销售;制冷、空调设备销售;办公设备耗材销售;软件销售;棕制品销售;竹制品销售;计算器设备销售;皮革销售;日用玻璃制品销售;卫生洁具销售;灯具销售;玩具、动漫及游艺用品销售;户外用品销售;箱包销售;眼镜销售（不含隐形眼镜）;钟表销售;母婴用品销售;礼品花卉销售;日用品销售;针纺织品销售;家用电器零配件销售;家具零配件销售;特种劳动防护用品销售;消防器材销售;办公设备销售;仪器仪表销售;管道运输设备销售;金属制品销售;橡胶制品销售;个人卫生用品销售;广播影视设备销售;照明器具销售;物联网设备销售;木竹材加工机械销售;钟表与计时仪器销售;木制容器销售;劳动保护用品销售;特种陶瓷制品销售;金属包装容器及材料销售;文具用品零售;游艺用品及室内游艺器材销售;智能仪器仪表销售;皮革制品销售;包装专用设备销售;食品用洗涤剂销售;网络文化经营;演出场所经营;营业性演出;电影发行;电影放映;电视剧发行;音像制品制作;电视剧制作;广播电视节目制作经营;信息网络传播视听节目;食品互联网销售（销售预包装食品）;食品互联网销售
广州云鹊文化传媒有限公司	互联网商品销售（许可审批类商品除外）;音像经纪代理服务;市场营销策划服务;策划创意服务;群众参与的文艺类演出、比赛等公益性文化活动的策划;多媒体设计服务;大型活动组织策划服务（大型活动指晚会、运动会、庆典、艺术和模特大赛、艺术节、电影节及公益演出、展览等,需专项审批的活动应在取得审批后方可经营）;文化娱乐经纪人;影视经纪代理服务;文化艺术咨询服务;企业形象策划服务;文化推广（不含许可经营项目）;个人形象设计服务;广告业;摄影服务;文化传播（不含许可经营项目）;音像制品制作;网上视频服务;信息网络传播视听节目业务;演出经纪代理服务
广州新月演艺经纪有限公司	文化娱乐经纪人;信息技术咨询服务;数字动漫制作;音像经纪代理服务;版权服务;文化艺术咨询服务;大型活动组织策划服务（大型活动指晚会、运动会、庆典、艺术和模特大赛、艺术节、电影节及公益演出、展览等，需专项审批的活动应在取得审批后方可经营）;演出经纪代理服务;营业性文艺表演
广州铭凯健身有限公司	健身休闲活动;体育健康服务;互联网销售（除销售需要许可的商品）;体育用品及器材批发;体育用品及器材零售;游艺用品及室内游艺器材销售;台球活动;普通机械设备安装服务;组织文化艺术交流活动;组织体育表演活动;游艺及娱乐用品销售;高危险性体育运动（游泳）;食品经营;食品经营（销售预包装食品）;美容服务;小餐饮;食品互联网销售（销售预包装食品）
中视智媒（广州）文化传媒有限公司	互联网销售（除销售需要许可的商品）;摄像及视频制作服务;劳务服务（不含劳务派遣）;人力资源服务（不含职业中介活动、劳务派遣服务）;业务培训（不含教育培训、职业技能培训等需取得许可的培训）;其他文化艺术经纪代理;文化娱乐经纪人服务;个人互联网直播服务（需备案）;日用品销售;礼仪服务;市场调查（不含涉外调查）;市场营销策划;图文设计制作;广告设计、代理;组织文化艺术交流活动;网络技术服务;广告发布（非广播电台、电视台、报刊出版单位）;技术服务、技术开发、技术咨询、技术交流、技术转让、技术推广;鞋帽批发;会议及展览服务;服装服饰批发;广告制作;广播电视节目制作经营;演出经纪;广告发布（广播电台、电视台、报刊出版单位）
广东才华文化发展有限公司	物业服务评估;物业管理;物联网技术服务;物联网应用服务;物联网设备销售;通讯设备销售;网络技术服务;网络设备销售;智能仪器仪表销售;仪器仪表销售;绘图、计算及测量仪器销售;电工仪器仪表销售;互联网数据服务;互联网设备销售;数字文化创意技术装备销售;数字文化创意内容应用服务;组织文化艺术交流活动;文化用品设备出租;人工智能基础软件开发;音响设备销售;乐器零售;报纸出租;图书出租;电子出版物出租;广播影视设备销售;广播电视设备专业修理;玩具、动漫及游艺用品销售;玩具销售;纸制品销售;广告设计、代理;信息技术咨询服务;计算机软硬件及辅助设备零售;体育用品及器材零售;软件开发;医用口罩批发;乐器批发;计算机软硬件及辅助设备批发;工艺美术品及收藏品批发（象牙及其制品除外）;日用品批发;体育用品及器材批发;医护人员防护用品批发;网络与信息安全软件开发;数字文化创意软件开发;软件销售;办公设备租赁服务;计算机及办公设备维修;办公设备耗材销售;办公设备销售;移动通信设备销售;通信设备销售;电子产品销售;电子元器件批发;电子专用材料销售;电子测量仪器销售;电子元器件与机电组件设备销售;电子元器件零售;环境卫生公共设施安装服务;信息系统集成服务;计算机系统服务;工业自动控制系统装置销售;工业控制计算机及系统销售;安全技术防范系统设计施工服务;人工智能行业应用系统集成服务;文具用品批发;文具用品零售;游艺及娱乐用品销售;休闲娱乐用品设备出租;游艺用品及室内游艺器材销售;文艺创作;文化场馆管理服务;出版物零售;出版物批发
广东世王会文化产业股份有限公司	文化艺术咨询服务;绘画艺术创作服务;书法篆刻创作服务;艺（美）术创作服务;艺（美）术品、收藏品鉴定、咨询服务;非物质文化遗产保护的技术研究、技术咨询;海味干货批发;生鲜家禽批发;水产品批发;干果、坚果批发;博物馆展品、藏品保护的技术研究、技术咨询;酒店管理;餐饮管理;社会法律咨询;法律文书代理;投资咨询服务;广告业;劳务承揽;会议及展览服务;担保服务（融资性担保除外）;为中小企业提供信用担保;开展个人置业贷款担保业务（融资性担保除外）;企业自有资金投资;招、投标代理服务;软件开发;信息技术咨询服务;网络技术的研究、开发;计算机技术开发、技术服务;商品批发贸易（许可审批类商品除外）;互联网商品销售（许可审批类商品除外）;化妆品及卫生用品批发;清洁用品批发;陶瓷、玻璃器皿批发;陶瓷装饰材料零售;家具批发;预包装食品批发;非酒精饮料、茶叶批发;酒类零售
广东战狼影视有限公司	录音制作;电影放映;电影和影视节目发行;音像制品制作;电影和影视节目制作;赛事转播服务;信息网络传播视听节目业务;音像制品出版
广东政工影视传媒有限公司	电影和影视节目制作;电影和影视节目发行;文艺创作服务;广告业;大型活动组织策划服务（大型活动指晚会、运动会、庆典、艺术和模特大赛、艺术节、电影节及公益演出、展览等，需专项审批的活动应在取得审批后方可经营）
广州纯之音音乐文化有限公司	组织文化艺术交流活动;乐器零售;乐器批发;文艺创作;文化娱乐经纪人服务;乐器维修、调试;音响设备销售;艺（美）术品、收藏品鉴定评估服务;信息技术咨询服务;咨询策划服务;互联网销售（除销售需要许可的商品）;技术服务、技术开发、技术咨询、技术交流、技术转让、技术推广;信息咨询服务（不含许可类信息咨询服务）;市场营销策划;企业管理;企业管理咨询;广告设计、代理;广告发布（非广播电台、电视台、报刊出版单位）;广告制作
广州巴国文化发展有限公司	雕刻艺术创作服务;绘画艺术创作服务;非物质文化遗产保护的技术研究、技术咨询;文化艺术咨询服务;园林、陈设艺术及其他陶瓷制品制造;策划创意服务;企业管理咨询服务;企业形象策划服务;广告业;市场营销策划服务;商品信息咨询服务;会议及展览服务;货物进出口（专营专控商品除外）;商品批发贸易（许可审批类商品除外）;办公设备批发;办公服务;日用器皿及日用杂货批发;室内装饰设计服务;电脑喷绘、晒图服务;电脑打字、录入、校对、打印服务
广东省宋氏文化传播（集团）有限公司	文艺创作;体育竞赛组织;体育中介代理服务;组织体育表演活动;体育用品及器材批发;体育用品及器材零售;体育用品设备出租;图书出租;组织文化艺术交流活动;其他文化艺术经纪代理;文化娱乐经纪人服务;租借道具活动;娱乐性展览;互联网销售（除销售需要许可的商品）;教育咨询服务（不含涉许可审批的教育培训活动）;包装专用设备销售;制浆和造纸专用设备销售;纺织专用设备销售;仓储设备租赁服务;物联网设备销售;幻灯及投影设备销售;计算机及办公设备维修;办公设备销售;电子元器件与机电组件设备销售;计算机软硬件及辅助设备批发;计算器设备销售;照明器具生产专用设备销售;机械设备租赁;通讯设备销售;报纸出租;纸浆销售;纸制品销售;软件销售;区块链技术相关软件和服务;软件外包服务;网络与信息安全软件开发;技术服务、技术开发、技术咨询、技术交流、技术转让、技术推广;新材料技术推广服务;游艺用品及室内游艺器材销售;家具销售;平面设计;广告设计、代理;专业设计服务;图文设计制作;日用品销售;文具用品零售;文具用品批发;日用品出租;日用家电零售;办公设备销售;办公用品销售;办公设备租赁服务;办公服务;园林绿化工程施工;城市绿化管理;教学专用仪器销售;教育教学检测和评价活动;教学用模型及教具销售;出版物批发;出版物零售
不染楼有限公司	艺（美）术品、收藏品鉴定评估服务;技术服务、技术开发、技术咨询、技术交流、技术转让、技术推广;国内贸易代理;工艺美术品及收藏品零售（象牙及其制品除外）;软件开发;信息系统集成服务;广告设计、代理;广告发布（非广播电台、电视台、报刊出版单位）;广告制作;食品互联网销售（仅销售预包装食品）;物联网设备销售;物联网技术服务;物联网应用服务;物联网技术研发
广州市金艺文化传媒有限公司	家用电器销售;日用家电零售;日用杂品销售;厨具卫具及日用杂品零售;建筑装饰材料销售;工艺美术品及收藏品零售（象牙及其制品除外）;皮革制品销售;皮革销售;日用木制品销售;鞋帽零售;服装辅料销售;服装服饰零售;塑料制品销售;玻璃纤维增强塑料制品销售;版权代理;文艺创作;体育用品设备出租;租借道具活动;影视美术道具置景服务;文化用品设备出租;家具零配件销售;组织文化艺术交流活动;日用百货销售;日用品销售;日用品批发;服装服饰批发;服装服饰出租;鞋帽批发;木制容器销售;互联网销售（除销售需要许可的商品）;社会经济咨询服务;市场营销策划;信息咨询服务（不含许可类信息咨询服务）;企业管理咨询;企业管理;企业形象策划;会议及展览服务;专业设计服务;个人商务服务;礼仪服务;摄影扩印服务;摄像及视频制作服务;工艺美术品及收藏品批发（象牙及其制品除外）;其他文化艺术经纪代理;文化娱乐经纪人服务;娱乐性展览;组织体育表演活动;技术服务、技术开发、技术咨询、技术交流、技术转让、技术推广;翻译服务;家用电器安装服务;普通机械设备安装服务;餐饮管理;广告制作;广告设计、代理;广告发布（非广播电台、电视台、报刊出版单位）;健康咨询服务（不含诊疗服务）;家居用品销售;珠宝首饰零售;珠宝首饰批发;非电力家用器具销售;家用视听设备销售;农副产品销售;电影摄制服务;个人互联网直播服务（需备案）;出版物零售;出版物互联网销售;食品互联网销售;食品互联网销售（销售预包装食品）;酒类经营;食品经营;食品经营（销售预包装食品）;营业性演出;演出经纪;互联网直播服务（不含新闻信息服务、网络表演、网络视听节目）;游艺娱乐活动;网络文化经营;信息网络传播视听节目;广播电视节目制作经营;电影发行;广播电视节目传送;音像制品制作;电视剧发行;电视剧制作;互联网上网服务;出版物批发;电子出版物制作;音像制品复制;第二类增值电信业务;第一类增值电信业务;货物进出口;技术进出口
广州魔芭文化发展有限公司	网络技术服务;广告发布（非广播电台、电视台、报刊出版单位）;玩具、动漫及游艺用品销售;日用品销售;日用口罩（非医用）销售;办公设备耗材销售;体育用品设备出租;茶具销售;珠宝首饰回收修理服务;珠宝首饰批发;家用视听设备销售;厨具卫具及日用杂品零售;鞋帽批发;钟表销售;体育中介代理服务;文化娱乐经纪人服务;体育经纪人服务;化妆品零售;体育用品及器材零售;鞋帽零售;信息技术咨询服务;企业信用评级服务;日用百货销售;体育用品及器材批发;互联网销售（除销售需要许可的商品）;服装服饰出租;服装辅料销售;技术服务、技术开发、技术咨询、技术交流、技术转让、技术推广;服装服饰批发;箱包销售;个人卫生用品销售;通讯设备销售;会议及展览服务;乐器零售;个人互联网直播服务（需备案）;日用家电零售;玩具销售;企业形象策划;日用化学产品销售;钟表与计时仪器销售;照相机及器材销售;企业信用管理咨询服务;化妆品批发;厨具卫具及日用杂品批发;电子产品销售;乐器批发;汽车零配件零售;礼品花卉销售;办公用品销售;日用杂品销售;摄像及视频制作服务;市场营销策划;服装、服饰检验、整理服务;广告设计、代理;日用品批发;服装服饰零售;珠宝首饰零售;家用电器零配件销售;体育健康服务;家居用品销售;教育咨询服务（不含涉许可审批的教育培训活动）;家用电器销售;汽车零配件批发;服装辅料销售;玩具销售;日用化学产品销售;日用杂品销售;家用电器销售;食品经营（销售预包装食品）;酒类经营;网络文化经营;食品互联网销售（销售预包装食品）;美容服务;保健食品销售
广州龙桢文化发展有限公司	展览馆;营业性文艺表演;演出经纪代理服务;广告业;文化娱乐经纪人;票务服务;场地租赁（不含仓储）;大型活动组织策划服务（大型活动指晚会、运动会、庆典、艺术和模特大赛、艺术节、电影节及公益演出、展览等,需专项审批的活动应在取得审批后方可经营）;会议及展览服务;艺术表演场馆管理服务;舞台表演艺术指导服务;舞台灯光、音响设备安装服务;珠宝鉴定服务;体育组织;代售福利彩票、体育彩票;影视经纪代理服务;音像经纪代理服务;文学、艺（美）术经纪代理服务;文艺创作服务;体育器材装备安装服务
广州编辅侠科技有限公司	新材料技术研发;工程和技术研究和试验发展;公园、景区小型设施娱乐活动;组织文化艺术交流活动;组织体育表演活动;智能机器人的研发;服务消费机器人销售;工业机器人销售;智能机器人销售;网络技术服务;计算机系统服务;电子出版物出租;电子产品销售;电子专用设备销售;新材料技术推广服务;信息系统集成服务;教学用模型及教具销售;教学专用仪器销售;互联网销售（除销售需要许可的商品）;会议及展览服务;数字内容制作服务（不含出版发行）;数字文化创意技术装备销售;数据处理服务;数据处理和存储支持服务;互联网数据服务;公共事业管理服务;网络与信息安全软件开发;软件外包服务;人工智能基础软件开发;软件开发;区块链技术相关软件和服务;软件销售;咨询策划服务;资源循环利用服务技术咨询;技术服务、技术开发、技术咨询、技术交流、技术转让、技术推广;环保咨询服务;社会经济咨询服务;财务咨询;信息技术咨询服务;人工智能公共服务平台技术咨询服务;企业管理咨询;企业形象策划;企业管理;企业总部管理;市场营销策划;市场调查（不含涉外调查）
广州大容和文化创意产业有限公司	供应链管理服务;个人互联网直播服务（需备案）;摄像及视频制作服务;品牌管理;互联网销售（除销售需要许可的商品）;互联网数据服务;个人卫生用品销售;宠物食品及用品批发;办公用品销售;智能家庭消费设备销售;日用品销售;文具用品批发;玩具、动漫及游艺用品销售;服装服饰批发;服装服饰零售;箱包销售;针纺织品及原料销售;日用百货销售;化妆品批发;化妆品零售;通讯设备销售;电子产品销售;农副产品销售;物联网技术研发;家用电器销售;卫生用品和一次性使用医疗用品销售;技术服务、技术开发、技术咨询、技术交流、技术转让、技术推广;教育咨询服务（不含涉许可审批的教育培训活动）;业务培训（不含教育培训、职业技能培训等需取得许可的培训）;数字文化创意软件开发;数字文化创意内容应用服务;广告设计、代理;广告发布（非广播电台、电视台、报刊出版单位）;母婴用品销售;玩具制造;文具用品零售;家居用品制造;文化用品设备出租;其他文化艺术经纪代理;组织文化艺术交流活动;电子出版物出租;广告制作;信息技术咨询服务;咨询策划服务;信息咨询服务（不含许可类信息咨询服务）;人工智能公共服务平台技术咨询服务;互联网直播服务（不含新闻信息服务、网络表演、网络视听节目）;技术进出口;货物进出口;药品互联网信息服务;食品互联网销售;食品经营（销售预包装食品）;食品经营（销售散装食品）
广州西适体健身服务有限公司	从事语言能力、艺术、体育、科技等培训的营利性民办培训服务机构（除面向中小学生开展的学科类、语言类文化教育培训）;体育健康服务;体育用品及器材批发;服装服饰零售;人力资源服务（不含职业中介活动、劳务派遣服务）;健康咨询服务（不含诊疗服务）;企业总部管理;企业管理咨询;企业管理;财务咨询;教育咨询服务（不含涉许可审批的教育培训活动）;互联网销售（除销售需要许可的商品）;贸易经纪;中医养生保健服务（非医疗）;婚姻介绍服务;体育场地设施经营（不含高危险性体育运动）;货物进出口
广州十年好友影视有限公司	电影和影视节目制作;电影和影视节目发行;电影放映;网上电影服务;市场营销策划服务;动漫及衍生产品设计服务;广告业;文化娱乐经纪人;文艺创作服务;会议及展览服务;策划创意服务;文化推广（不含许可经营项目）;票务服务;文化艺术咨询服务;企业形象策划服务;大型活动组织策划服务（大型活动指晚会、运动会、庆典、艺术和模特大赛、艺术节、电影节及公益演出、展览等，需专项审批的活动应在取得审批后方可经营）;文化传播（不含许可经营项目）;群众参与的文艺类演出、比赛等公益性文化活动的策划
广州正元文化传播有限公司	教育咨询服务;大型活动组织策划服务（大型活动指晚会、运动会、庆典、艺术和模特大赛、艺术节、电影节及公益演出、展览等，需专项审批的活动应在取得审批后方可经营）;文化艺术咨询服务;酒店管理;餐饮管理;企业总部管理;商品零售贸易（许可审批类商品除外）;商品批发贸易（许可审批类商品除外）;信息技术咨询服务;绘画艺术创作服务;艺术表演场馆管理服务;舞台表演艺术指导服务;教育评估;文化传播（不含许可经营项目）
广州玖乐文化传播有限公司	清洁用品批发;卫生盥洗设备及用具批发;消毒用品销售（涉及许可经营的项目除外）;化妆品零售;厨房用具及日用杂品零售;文艺创作服务;群众参与的文艺类演出、比赛等公益性文化活动的策划;文化传播（不含许可经营项目）;文化推广（不含许可经营项目）;企业管理咨询服务;企业形象策划服务;文化艺术咨询服务;策划创意服务;投资咨询服务;市场营销策划服务;广告业;会议及展览服务;多媒体设计服务;展台设计服务;美术图案设计服务;摄影服务;化妆品批发;日用器皿及日用杂货批发
广州不易文化传播有限公司	营业性文艺表演;出版物进口经营;文物经营;文艺创作服务;雕刻艺术创作服务;绘画艺术创作服务;书法篆刻创作服务;艺（美）术创作服务;艺（美）术装裱、封装服务;具有纪念性建筑物保护的技术研究、技术咨询;具有文化价值遗址保护的技术研究、技术咨询;文物古迹保护的技术研究、技术咨询;传统建筑、历史性建筑保护的技术研究、技术咨询;博物馆展品、藏品保护的技术研究、技术咨询;非物质文化遗产保护的技术研究、技术咨询;日用器皿及日用杂货批发;灯具、装饰物品批发;家具批发;文具用品批发;钻石饰品批发;宝石饰品批发;玉石饰品批发;水晶首饰批发;工艺品批发;美术品批发;收藏品批发（国家专营专控的除外）;珍珠饰品批发;其他人造首饰、饰品批发;钻石销售;集邮品批发和进出口;玩具批发;游艺及娱乐用品批发;乐器批发;其他文化娱乐用品批发;货物进出口（专营专控商品除外）;技术进出口;商品批发贸易（许可审批类商品除外）;黄金制品批发;白银制品批发;木质装饰材料零售;玉石饰品零售;工艺美术品零售;清扫、清洗日用品零售;陶瓷、玻璃器皿零售;乐器零售;珍珠饰品零售;礼品鲜花零售;商品零售贸易（许可审批类商品除外）;黄金制品零售;铂金制品零售;金属装饰材料零售;其他人造首饰、饰品零售;水晶饰品零售;小饰物、小礼品零售;宝石饰品零售;铂金制品批发;收购古旧书籍、碑帖、拓本、字画等工艺美术品（文物除外,法律禁止经营的不得经营,涉及许可证的凭许可证经营）;互联网商品零售（许可审批类商品除外）;装饰用塑料、化纤、石膏、布料零售;钻石首饰零售;木制、塑料、皮革日用品零售;陶瓷装饰材料零售;照相器材零售;白银制品零售;收藏品零售（国家专营专控的除外）
广州尔码文化传播有限公司	项目策划与公关服务;企业形象策划;市场营销策划;咨询策划服务;广告设计、代理;广告发布（非广播电台、电视台、报刊出版单位）;广告制作;文艺创作;信息咨询服务（不含许可类信息咨询服务）;网络技术服务;信息技术咨询服务;技术服务、技术开发、技术咨询、技术交流、技术转让、技术推广;业务培训（不含教育培训、职业技能培训等需取得许可的培训）;互联网销售（除销售需要许可的商品）;第一类增值电信业务
广东羊城博物馆有限公司	展览馆;现金、有价证券、重要凭证、金银珠宝、文物等及其它贵重物品的武装守护、押运;文物经营;宝石、玉石采选;出版物进口经营;进出口商品检验鉴定（具体经营项目以《进出口商品检验鉴定机构资格证书》载明为准）;美术馆;博物馆展品、藏品保护的技术研究、技术咨询;文物古迹保护的技术研究、技术咨询;收购古旧书籍、碑帖、拓本、字画等工艺美术品（文物除外，法律禁止经营的不得经营，涉及许可证的凭许可证经营）;珠宝玉石检测服务;玉石饰品批发;玉石饰品零售;收藏品批发（国家专营专控的除外）;收藏品零售（国家专营专控的除外）;收藏品的修复、养护服务;艺（美）术品、收藏品鉴定、咨询服务;珍珠饰品批发;珍珠饰品零售;美术展览经纪代理服务;工艺美术品零售（象牙及其制品除外）;宝石饰品批发;宝石饰品零售;钻石饰品批发;钻石销售;钻石首饰零售;工艺品批发（象牙及其制品除外）;绘画艺术创作服务;艺（美）术装裱、封装服务;具有纪念性建筑物保护的技术研究、技术咨询;具有文化价值遗址保护的技术研究、技术咨询;传统建筑、历史性建筑保护的技术研究、技术咨询;珠宝鉴定服务;文献书籍修复;档案修复;档案管理服务;档案管理技术服务;档案鉴定;文学、艺（美）术经纪代理服务;货物进出口（专营专控商品除外）;集邮品批发和进出口;茶叶作物及饮料作物批发;白银制品批发;文化艺术咨询服务;白银制品零售;技术进出口;黄金制品批发;经政府有关部门授权，从事罚没物资、假冒商品的销毁;拆解、回收利用罚没物资及查处的假冒商品;企业产权交易的受托代理;土地评估;美术品批发（象牙及其制品除外）;雕刻艺术创作服务
广州美辰琦文化发展有限公司	经营民宿;礼仪服务;广告制作;以自有资金从事投资活动;广告发布（非广播电台、电视台、报刊出版单位）;项目策划与公关服务;票务代理服务;图文设计制作;办公服务;会议及展览服务;广告设计、代理;电子出版物出租;音像制品出租;文化用品设备出租;体育用品设备出租;休闲娱乐用品设备出租;办公设备租赁服务;机械设备租赁;非居住房地产租赁;房地产经纪;物业管理;工艺美术品及礼仪用品销售（象牙及其制品除外）;音响设备销售;广播电视传输设备销售;销售代理;贸易经纪;艺术品代理;游艺及娱乐用品销售;体育用品及器材批发;办公用品销售;卫生用品和一次性使用医疗用品销售;办公设备销售;广播影视设备销售;娱乐性展览;租借道具活动;公园、景区小型设施娱乐活动;组织文化艺术交流活动;其他文化艺术经纪代理;体育经纪人服务;文化娱乐经纪人服务;组织体育表演活动;体育健康服务;体育中介代理服务;电影摄制服务;文化场馆管理服务;个人互联网直播服务（需备案）;艺（美）术品、收藏品鉴定评估服务;文艺创作;演出经纪;营业性演出
广州市动益健健身有限公司	健身服务;全民健身科技服务;室内非射击类、非球类、非棋牌类的竞技娱乐活动（不含电子游艺、攀岩、蹦床）;体育用品及器材零售;游艺娱乐用品零售;体育培训;体育用品及器材批发;社区、街心公园、公园等运动场所的管理服务;竞技体育科技服务;体育工程科技服务;体育器材装备安装服务;瑜伽辅导服务;体育组织;体育设备、器材出租;保龄球服务;台球服务;体育、休闲娱乐工程设计服务;体育赛事运营（涉及许可项目的,需取得许可后方可经营）
广州张越文化传媒有限公司	其他文化艺术经纪代理;组织文化艺术交流活动;咨询策划服务;艺（美）术品、收藏品鉴定评估服务;信息技术咨询服务;数字文化创意内容应用服务;市场营销策划;企业形象策划;摄影扩印服务;化妆品零售;互联网销售（除销售需要许可的商品）;日用杂品销售;箱包销售;技术服务、技术开发、技术咨询、技术交流、技术转让、技术推广;鞋帽零售;服装服饰零售;卫生用品和一次性使用医疗用品销售;日用百货销售;信息咨询服务（不含许可类信息咨询服务）;珠宝首饰零售;美发饰品销售;音像制品制作;食品经营（销售预包装食品）;食品互联网销售（销售预包装食品）
广州天玛云秀影视传媒有限公司	家具设计服务;舞台机械设计安装服务;彩灯、花灯设计服务;舞台表演艺术指导服务;文化产业园的投资、招商、开发、建设;投资咨询服务;项目投资（不含许可经营项目，法律法规禁止经营的项目不得经营）;为公民出国定居、探亲、访友、继承财产和其它非公务活动提供信息介绍、法律咨询、沟通联系、境外安排、签证申请及相关的服务;影视经纪代理服务;文化娱乐经纪人;音像经纪代理服务;文学、艺（美）术经纪代理服务;美术展览经纪代理服务;动漫（动画）经纪代理服务;广告业;新媒体产业园的投资、招商、开发、建设;多媒体设计服务;会议及展览服务;摄影服务;企业形象策划服务;市场营销策划服务;体育营销策划服务;大型活动组织策划服务（大型活动指晚会、运动会、庆典、艺术和模特大赛、艺术节、电影节及公益演出、展览等，需专项审批的活动应在取得审批后方可经营）;群众参与的文艺类演出、比赛等公益性文化活动的策划;个人形象设计服务;时装设计服务;包装装潢设计服务;动漫及衍生产品设计服务;饰物装饰设计服务;展台设计服务;模型设计服务;策划创意服务;美术图案设计服务;广播电视节目制作（具体经营范围以《广播电视节目制作经营许可证》为准）;音像制品制作;电影和影视节目发行;电影和影视节目制作
广州泰城文化产业发展有限公司	养老产业投资、开发;房地产开发经营;物业管理;房屋建筑工程施工;酒店管理;观光果园管理服务（以向游客提供采摘为主的活动）;公园、景区内游船出租活动;养生学的研究开发及技术转让;健康管理咨询服务（须经审批的诊疗活动、心理咨询除外，不含许可经营项目，法律法规禁止经营的项目不得经营）;政府采购咨询服务;文化产业园的投资、招商、开发、建设;营养健康咨询服务;投资咨询服务;舞台表演美工服务;旅游景区规划设计、开发、管理;移民咨询服务（不含就业、留学咨询）;体育、休闲娱乐工程设计服务;自有房地产经营活动;房屋租赁;房屋拆迁服务;房地产中介服务;房地产咨询服务;房地产投资（不含许可经营项目，法律法规禁止经营的项目不得经营）;物业出租;代办按揭服务;受托代理住房公积金相关服务;餐饮管理;企业管理服务（涉及许可经营项目的除外）
广州鸿星文化传媒有限公司	文化传播（不含许可经营项目）;文化推广（不含许可经营项目）;文化艺术咨询服务;商务咨询服务;影视经纪代理服务;音像经纪代理服务;信息技术咨询服务;文学、艺（美）术经纪代理服务;市场营销策划服务;体育营销策划服务;企业形象策划服务;大型活动组织策划服务（大型活动指晚会、运动会、庆典、艺术和模特大赛、艺术节、电影节及公益演出、展览等，需专项审批的活动应在取得审批后方可经营）;企业管理咨询服务;策划创意服务;时装设计服务;模型设计服务;饰物装饰设计服务;个人形象设计服务;计算机技术开发、技术服务;舞台机械设计安装服务;展台设计服务;照明灯光设计服务;多媒体设计服务;广播电视节目制作及发射设备制造;数字动漫制作;广告业;公司礼仪服务;音频和视频设备租赁;灯光设备租赁;软件开发;计算机硬件的研究、开发;电子商务信息咨询;网络信息技术推广服务;受企业委托从事通信网络的维修、维护（不涉及线路管道铺设等工程施工）;动漫及衍生产品设计服务;体育运动咨询服务;化妆品批发;化妆品零售;鞋批发;头饰批发;纺织品、针织品及原料批发;服装批发;服装辅料批发;办公设备批发;乐器批发;乐器零售;音响设备制造;舞台灯光、音响设备安装服务;网上视频服务;网络音乐服务;演出经纪代理服务;人事代理;录音制作;音像制品制作;信息网络传播视听节目业务
广州香蕉文化发展有限公司	商品零售贸易（许可审批类商品除外）;文艺创作服务;其他文化娱乐用品批发;非许可类医疗器械经营;医疗用品及器材零售（不含药品及医疗器械）;商品批发贸易（许可审批类商品除外）;互联网商品零售（许可审批类商品除外）;包装装潢设计服务;货物进出口（专营专控商品除外）;化妆品及卫生用品零售;技术进出口;化妆品及卫生用品批发;广告业;医疗、医药咨询服务（不涉及医疗诊断、治疗及康复服务）;医疗技术推广服务;医疗技术咨询、交流服务;网络信息技术推广服务;信息技术咨询服务;软件技术推广服务;网络技术的研究、开发;计算机技术开发、技术服务;科技信息咨询服务;软件开发;软件服务;预包装食品零售;预包装食品批发
广州白云山文化产业有限公司	旅游开发项目策划咨询;面向家长实施的家庭教育咨询服务;体验式拓展活动及策划;企业管理咨询;品牌管理;广告制作;广告发布（非广播电台、电视台、报刊出版单位）;社会调查（不含涉外调查）;体育保障组织;租借道具活动;组织文化艺术交流活动;休闲观光活动;史料、史志编辑服务;非物质文化遗产保护;组织体育表演活动;文物文化遗址保护服务;体育中介代理服务;公园、景区小型设施娱乐活动;文化场馆管理服务;艺（美）术品、收藏品鉴定评估服务;体育经纪人服务;文艺创作;体育竞赛组织;文化娱乐经纪人服务;体育健康服务;健身休闲活动;其他文化艺术经纪代理;娱乐性展览;电影摄制服务;游乐园服务;个人互联网直播服务（需备案）;数字内容制作服务（不含出版发行）;休闲娱乐用品设备出租;日用品出租;从事与外国（地区）企业相关的非营利性业务活动;酒店管理;餐饮管理;公共事业管理服务;园区管理服务;商业综合体管理服务;市场营销策划;企业形象策划;健康咨询服务（不含诊疗服务）;广告设计、代理;会议及展览服务;图文设计制作;项目策划与公关服务;名胜风景区管理;森林公园管理;游览景区管理;植物园管理服务;婚庆礼仪服务;中医养生保健服务（非医疗）;摄像及视频制作服务;咨询策划服务;职工疗休养策划服务;食品互联网销售（仅销售预包装食品）;食品销售（仅销售预包装食品）;日用百货销售;游艺及娱乐用品销售;艺术品代理;销售代理;保健食品（预包装）销售;日用口罩（非医用）销售;卫生用品和一次性使用医疗用品销售;医护人员防护用品零售;服装服饰零售;鞋帽零售;医用口罩零售;化妆品零售;文具用品零售;体育用品及器材零售;珠宝首饰零售;工艺美术品及收藏品零售（象牙及其制品除外）;电子产品销售;特殊医学用途配方食品销售;针纺织品销售;个人卫生用品销售;礼品花卉销售;母婴用品销售;眼镜销售（不含隐形眼镜）;箱包销售;户外用品销售;玩具、动漫及游艺用品销售;互联网销售（除销售需要许可的商品）;中草药收购;教学专用仪器销售;游艺用品及室内游艺器材销售;玩具销售;纸制品销售;日用杂品制造;办公用品销售;茶具销售;金银制品销售;美发饰品销售;露营地服务;经营民宿;园林绿化工程施工;对外承包工程;市场调查（不含涉外调查）;人工造林;森林经营和管护;树木种植经营;水产养殖珍珠购销;工艺美术品及礼仪用品制造（象牙及其制品除外）;珠宝首饰制造
抖爆数智科技（广州）有限公司	信息技术咨询服务;项目策划与公关服务;广告发布（非广播电台、电视台、报刊出版单位）;个人互联网直播服务（需备案）;企业总部管理;贸易经纪;社会经济咨询服务;会议及展览服务;品牌管理;市场营销策划;供应链管理服务;企业管理咨询;社会调查（不含涉外调查）;企业形象策划;其他文化艺术经纪代理;公共事业管理服务;广告设计、代理;国内贸易代理;技术服务、技术开发、技术咨询、技术交流、技术转让、技术推广;组织文化艺术交流活动;互联网销售（除销售需要许可的商品）;文化娱乐经纪人服务;信息咨询服务（不含许可类信息咨询服务）;健康咨询服务（不含诊疗服务）;市场调查（不含涉外调查）;企业管理;互联网上网服务;广播电视节目制作经营;信息网络传播视听节目;互联网直播服务（不含新闻信息服务、网络表演、网络视听节目）
广州旭彩文化传媒有限公司	企业管理;箱包销售;电子产品销售;化妆品零售;珠宝首饰零售;品牌管理;互联网数据服务;皮革制品销售;水产品零售;电子元器件零售;广告设计、代理;技术服务、技术开发、技术咨询、技术交流、技术转让、技术推广;市场营销策划;数字文化创意软件开发;五金产品零售;家用电器销售;服装辅料销售;文化娱乐经纪人服务;个人互联网直播服务（需备案）;服装服饰零售;棉、麻销售;区块链技术相关软件和服务;广告发布（非广播电台、电视台、报刊出版单位）;企业形象策划;互联网销售（除销售需要许可的商品）;日用品销售;新鲜水果零售;文艺创作;数字文化创意内容应用服务;日用百货销售;鞋帽零售;钟表与计时仪器销售;钟表销售;互联网直播服务（不含新闻信息服务、网络表演、网络视听节目）;食品经营（销售预包装食品）;信息网络传播视听节目;音像制品制作;网络文化经营;食品互联网销售;保健食品销售;酒类经营
广州华魅影视传媒有限公司	广播电视节目制作（具体经营范围以《广播电视节目制作经营许可证》为准）;国内广播节目播出服务;付费广播节目播出服务;网上电影服务;电影和影视节目制作;电影和影视节目发行;电影放映;广告业;大型活动组织策划服务（大型活动指晚会、运动会、庆典、艺术和模特大赛、艺术节、电影节及公益演出、展览等，需专项审批的活动应在取得审批后方可经营）;策划创意服务;市场营销策划服务;群众参与的文艺类演出、比赛等公益性文化活动的策划;企业管理服务（涉及许可经营项目的除外）;企业管理咨询服务;新媒体产业园的投资、招商、开发、建设;多媒体设计服务
广州伍福丰实业有限公司	金属制日用品制造;会议及展览服务;市场营销策划;企业管理咨询;广告制作;广告发布（非广播电台、电视台、报刊出版单位）;广告设计、代理;技术服务、技术开发、技术咨询、技术交流、技术转让、技术推广
广州新钜禾文化发展有限公司	电子设备工程安装服务;多媒体设计服务;摄影服务;照明灯光设计服务;舞台灯光、音响设备安装服务;企业形象策划服务;室内装饰、装修;室内装饰设计服务;园林绿化工程服务;市政工程设计服务;计算机网络系统工程服务;计算机技术开发、技术服务;文艺创作服务;艺（美）术创作服务;电脑喷绘、晒图服务;策划创意服务;市场营销策划服务;大型活动组织策划服务（大型活动指晚会、运动会、庆典、艺术和模特大赛、艺术节、电影节及公益演出、展览等，需专项审批的活动应在取得审批后方可经营）;会议及展览服务;公共关系服务;企业管理咨询服务;美术图案设计服务;广告业;商品批发贸易（许可审批类商品除外）;商品零售贸易（许可审批类商品除外）;商品信息咨询服务;群众参与的文艺类演出、比赛等公益性文化活动的策划;展台设计服务;雕塑工艺品制造;企业管理服务（涉及许可经营项目的除外）;文化艺术咨询服务;信息技术咨询服务;工程技术咨询服务;信息电子技术服务;软件开发;信息系统集成服务;软件服务;科技信息咨询服务;科技项目招标服务;科技项目代理服务;科技项目评估服务;科技成果鉴定服务;版权服务;商标代理等服务;办公服务;模型设计服务
广州小螺号文化传播有限公司	文艺创作;互联网销售（除销售需要许可的商品）;企业形象策划;企业管理;企业管理咨询;会议及展览服务;广播电视节目制作经营;电影发行;电影放映;信息网络传播视听节目;货物进出口;技术进出口
广东古艺文化传播有限公司	文艺创作服务;文化艺术咨询服务;策划创意服务;摄影服务;企业管理咨询服务;文具用品批发;服装批发;照相器材批发;电子产品批发;照片扩印及处理服务;服装和鞋帽出租服务;个人形象设计服务;商品批发贸易（许可审批类商品除外）;互联网商品销售（许可审批类商品除外）
广东天人山水旅游管理有限公司	游乐园服务;个人商务服务;礼仪服务;体育赛事策划;其他文化艺术经纪代理;文化娱乐经纪人服务;以自有资金从事投资活动;会议及展览服务;健康咨询服务（不含诊疗服务）;供应链管理服务;企业管理;企业管理咨询;餐饮管理;旅行社服务网点旅游招徕、咨询服务;农村民间工艺及制品、休闲农业和乡村旅游资源的开发经营;幼儿园外托管服务（不含餐饮、住宿、文化教育培训）;中小学生校外托管服务（不含餐饮、住宿、文化教育培训）;交通设施维修;远程健康管理服务;体育健康服务;机构养老服务;养老服务;创业投资（限投资未上市企业）;规划设计管理;工程技术服务（规划管理、勘察、设计、监理除外）;养生保健服务（非医疗）;中医养生保健服务（非医疗）;护理机构服务（不含医疗服务）;企业形象策划;咨询策划服务;组织文化艺术交流活动;版权代理;软件开发;数字文化创意软件开发;软件外包服务;停车场服务;日用百货销售;服装服饰零售;玩具销售;家用电器销售;体育用品及器材零售;休闲观光活动;工艺美术品及礼仪用品销售（象牙及其制品除外）;电子产品销售;化妆品零售;珠宝首饰零售;办公用品销售;家居用品销售;金属制品销售;日用木制品销售;纸制品销售;礼品花卉销售;针纺织品销售;劳动保护用品销售;智能无人飞行器销售;体育保障组织;体育竞赛组织;体育用品设备出租;体育中介代理服务;组织体育表演活动;户外用品销售;船舶租赁;互联网销售（除销售需要许可的商品）;新鲜蔬菜零售;新鲜水果零售;文具用品零售;工艺美术品及收藏品零售（象牙及其制品除外）;医用口罩零售;食用农产品零售;玩具、动漫及游艺用品销售;农业园艺服务;园艺产品种植;游艺及娱乐用品销售;农副产品销售;豆及薯类销售;谷物销售;皮革制品销售;自动售货机销售;日用杂品销售;文化场馆管理服务;婚庆礼仪服务;专业设计服务;摄像及视频制作服务;服装服饰出租;电影摄制服务;摄影扩印服务;花卉绿植租借与代管理;棋牌室服务;集中式快速充电站;电动汽车充电基础设施运营;露营地服务;健身休闲活动;休闲娱乐用品设备出租;公园、景区小型设施娱乐活动;演出经纪;旅游业务;住宿服务;餐饮服务;医疗服务;出版物零售;洗浴服务;体育场地设施经营（不含高危险性体育运动）;食品互联网销售;出版物互联网销售;小食杂;网络文化经营;食品经营（销售散装食品）;生活美容服务;游艺娱乐活动
广东鸿客实业集团有限公司	对外承包工程;园林绿化工程施工;土石方工程施工;体育场地设施工程施工;企业管理咨询;旅游开发项目策划咨询
广州香港马会赛马训练有限公司	运动场馆服务（游泳馆除外）;健身服务;竞技体育科技服务;全民健身科技服务;体育工程科技服务
广东爱上新材料股份有限公司	生态环境材料制造;合成材料制造（不含危险化学品）;合成材料销售;健身休闲活动;体育用品制造;涂料制造（不含危险化学品）;涂料销售（不含危险化学品）;草及相关制品制造;草及相关制品销售;塑胶表面处理;体育场地设施工程施工;对外承包工程;体育用品及器材批发;体育用品及器材零售;工程塑料及合成树脂销售
河马体育健身（广州）有限公司	全民健身科技服务;健身服务;体育组织;体育运动咨询服务;体育营销策划服务;体育用品及器材批发;体育用品及器材零售;体育设备、器材出租;美容健身咨询服务;营养健康咨询服务;公司礼仪服务;公共关系服务;市场营销策划服务;教育咨询服务;会议及展览服务;大型活动组织策划服务（大型活动指晚会、运动会、庆典、艺术和模特大赛、艺术节、电影节及公益演出、展览等，需专项审批的活动应在取得审批后方可经营）;商品批发贸易（许可审批类商品除外）;商品零售贸易（许可审批类商品除外）;互联网商品零售（许可审批类商品除外）
广州凌天体育产业有限公司	体育、休闲娱乐工程设计服务;室内体育场、娱乐设施工程服务;室外体育设施工程施工;室外娱乐用设施工程施工;合成橡胶制造（监控化学品、危险化学品除外）;涂料制造（监控化学品、危险化学品除外）;其他合成材料制造（监控化学品、危险化学品除外）;粘合剂制造（监控化学品、危险化学品除外）;体育器材装备安装服务;运动场馆服务（游泳馆除外）;建筑物电力系统安装;建筑物自来水系统安装服务;人造草坪制造;塑料丝、绳及编织品制造;商品批发贸易（许可审批类商品除外）;材料科学研究、技术开发;货物进出口（专营专控商品除外）;佣金代理;轻质建筑材料制造;技术进出口;销售本公司生产的产品（国家法律法规禁止经营的项目除外;涉及许可经营的产品需取得许可证后方可经营）
广州市润文堂文化传播有限公司	艺术表演场馆管理服务;群众参与的文艺类演出、比赛等公益性文化活动的策划;文艺创作服务;艺（美）术创作服务;企业形象策划服务;会议及展览服务;商品批发贸易（许可审批类商品除外）;贸易咨询服务;广告业;照明灯光设计服务;舞台表演美工服务;教育咨询服务;职业技能培训（不包括需要取得许可审批方可经营的职业技能培训项目）;体育培训;酒店从业人员培训;语言培训;国学教育咨询服务;国学文化推广服务;文化艺术咨询服务;大型活动组织策划服务（大型活动指晚会、运动会、庆典、艺术和模特大赛、艺术节、电影节及公益演出、展览等,需专项审批的活动应在取得审批后方可经营）
广州市影天文化传播有限公司	策划创意服务;企业管理咨询服务;广告业;场地租赁（不含仓储）;市场营销策划服务;文艺创作服务;文化艺术咨询服务;电影放映;预包装食品零售;预包装食品批发;散装食品批发;乳制品零售;非酒精饮料及茶叶零售;餐饮配送服务;散装食品零售;冷热饮品制售;小吃服务;甜品制售
广州半拍艺术有限公司	互联网销售（除销售需要许可的商品）;乐器零售;乐器批发;其他文化艺术经纪代理;文化场馆管理服务;组织文化艺术交流活动;;营业性演出
广东美丽行文化旅游传媒有限公司	广告业;大型活动组织策划服务（大型活动指晚会、运动会、庆典、艺术和模特大赛、艺术节、电影节及公益演出、展览等,需专项审批的活动应在取得审批后方可经营）;会议及展览服务;酒店管理;境内旅游和入境旅游招徕、咨询服务;出境旅游招徕、咨询服务;边境旅游招徕、咨询服务;向游客提供旅游、交通、住宿、餐饮等代理服务（不涉及旅行社业务）;旅游景区规划设计、开发、管理;企业自有资金投资;群众参与的文艺类演出、比赛等公益性文化活动的策划;文化推广（不含许可经营项目）;文化传播（不含许可经营项目）;广播电视节目制作（具体经营范围以《广播电视节目制作经营许可证》为准）;信息网络传播视听节目业务;演出经纪代理服务;营业性文艺表演
广州名逸影视有限公司	电影和影视节目制作;电影和影视节目发行;电影放映;预包装食品批发;广告业;票务服务;会议及展览服务;场地租赁（不含仓储）;信息技术咨询服务;商品批发贸易（许可审批类商品除外）;舞台安装、搭建服务;影视经纪代理服务;电影设备及其配件批发
星野纪文化（广州）有限公司	电影摄制服务;文艺创作;文化场馆管理服务;艺（美）术品、收藏品鉴定评估服务;个人互联网直播服务（需备案）;健身休闲活动;体育中介代理服务;体育竞赛组织;休闲观光活动;组织体育表演活动;文化娱乐经纪人服务;体育经纪人服务;其他文化艺术经纪代理;组织文化艺术交流活动;公园、景区小型设施娱乐活动;租借道具活动;娱乐性展览;文具用品零售;日用品销售;户外用品销售;互联网设备销售;包装材料及制品销售;软件销售;办公设备耗材销售;娱乐船和运动船销售;智能家庭消费设备销售;体育用品及器材零售;工艺美术品及收藏品零售（象牙及其制品除外）;农副产品销售;化妆品零售;体育用品及器材批发;礼品花卉销售;互联网销售（除销售需要许可的商品）;工艺美术品及收藏品批发（象牙及其制品除外）;化妆品批发;服装服饰批发;鞋帽批发;游艺及娱乐用品销售;照相机及器材销售;音响设备销售;纸制品销售;广播影视设备销售;国内贸易代理;艺术品代理;销售代理;办公用品销售;智能无人飞行器销售;电子产品销售;体育赛事策划;企业形象策划;单位后勤管理服务;办公服务;认证咨询;财务咨询;会议及展览服务;包装服务;图文设计制作;打字复印;翻译服务;商务代理代办服务;个人商务服务;项目策划与公关服务;广告发布（非广播电台、电视台、报刊出版单位）;工商登记代理代办;广告制作;品牌管理;企业信用管理咨询服务;企业管理咨询;企业管理;酒店管理;餐饮管理;市场营销策划;广告设计、代理;人力资源服务（不含职业中介活动、劳务派遣服务）;服装服饰出租;汽车租赁;办公设备租赁服务;休闲娱乐用品设备出租;体育用品设备出租;文化用品设备出租;电子出版物出租;礼仪服务;家宴服务;摄影扩印服务;婚庆礼仪服务;摄像及视频制作服务;咨询策划服务;影视美术道具置景服务
广州市釜洲文化艺术传播有限公司	绘画艺术创作服务;书法篆刻创作服务;艺（美）术品、收藏品鉴定、咨询服务;文化推广（不含许可经营项目）;文化传播（不含许可经营项目）;文艺创作服务;艺（美）术创作服务;教育咨询服务;雕刻艺术创作服务
广州市晨华文化传播有限公司	文艺创作服务;艺（美）术创作服务;群众参与的文艺类演出、比赛等公益性文化活动的策划;工艺品批发;工艺美术品零售;工艺美术辅导服务;动漫及衍生产品设计服务;计算机技术开发、技术服务;软件开发;计算机网络系统工程服务;游戏软件设计制作;货物进出口（专营专控商品除外）;技术进出口;商品批发贸易（许可审批类商品除外）;商品零售贸易（许可审批类商品除外）;游艺娱乐用品零售;体育用品及器材零售;游艺及娱乐用品批发;体育设备、器材出租
雷呐（广州）文化传媒有限公司	电影摄制服务;文艺创作;文化场馆管理服务;艺（美）术品、收藏品鉴定评估服务;个人互联网直播服务（需备案）;健身休闲活动;体育中介代理服务;体育竞赛组织;休闲观光活动;组织体育表演活动;文化娱乐经纪人服务;体育经纪人服务;其他文化艺术经纪代理;组织文化艺术交流活动;公园、景区小型设施娱乐活动;租借道具活动;娱乐性展览;文具用品零售;日用品销售;礼品花卉销售;户外用品销售;互联网设备销售;包装材料及制品销售;软件销售;办公设备耗材销售;娱乐船和运动船销售;智能家庭消费设备销售;工艺美术品及收藏品零售（象牙及其制品除外）;体育用品及器材零售;农副产品销售;化妆品零售;体育用品及器材批发;互联网销售（除销售需要许可的商品）;工艺美术品及收藏品批发（象牙及其制品除外）;化妆品批发;服装服饰批发;鞋帽批发;游艺及娱乐用品销售;照相机及器材销售;音响设备销售;纸制品销售;广播影视设备销售;国内贸易代理;艺术品代理;销售代理;办公用品销售;智能无人飞行器销售;电子产品销售;体育赛事策划;企业形象策划;单位后勤管理服务;办公服务;认证咨询;财务咨询;会议及展览服务;包装服务;图文设计制作;打字复印;翻译服务;商务代理代办服务;个人商务服务;项目策划与公关服务;广告发布（非广播电台、电视台、报刊出版单位）;工商登记代理代办;广告制作;品牌管理;企业信用管理咨询服务;企业管理;酒店管理;餐饮管理;市场营销策划;广告设计、代理;人力资源服务（不含职业中介活动、劳务派遣服务）;服装服饰出租;汽车租赁;办公设备租赁服务;休闲娱乐用品设备出租;体育用品设备出租;文化用品设备出租;电子出版物出租;礼仪服务;家宴服务;摄影扩印服务;婚庆礼仪服务;摄像及视频制作服务;咨询策划服务;影视美术道具置景服务;数字文化创意内容应用服务;数字内容制作服务（不含出版发行）;数字文化创意软件开发;动漫游戏开发;露营地服务;旅客票务代理;普通货物仓储服务（不含危险化学品等需许可审批的项目）;粮油仓储服务
广州骏永体育发展有限公司	体育保障组织;体育健康服务;体育竞赛组织;健身休闲活动;农村民间工艺及制品、休闲农业和乡村旅游资源的开发经营;休闲娱乐用品设备出租;休闲观光活动;与农业生产经营有关的技术、信息、设施建设运营等服务;餐饮管理;园区管理服务;游览景区管理;市政设施管理;体验式拓展活动及策划;体育赛事策划;组织体育表演活动;体育经纪人服务;从事体育培训的营利性民办培训机构（除面向中小学生开展的学科类、语言类文化教育培训）;体育用品及器材批发;体育场地设施工程施工;体育用品及器材零售;体育用品设备出租;咨询策划服务;从事语言能力、艺术、体育、科技等培训的营利性民办培训服务机构（除面向中小学生开展的学科类、语言类文化教育培训）;高危险性体育运动（攀岩）;体育场地设施经营（不含高危险性体育运动）;旅游业务
广州市艺素视界文化传媒有限公司	电影和影视节目制作;文化艺术咨询服务;文化研究;文化推广（不含许可经营项目）;文化传播（不含许可经营项目）;多媒体设计服务;广告业;群众参与的文艺类演出、比赛等公益性文化活动的策划;大型活动组织策划服务（大型活动指晚会、运动会、庆典、艺术和模特大赛、艺术节、电影节及公益演出、展览等,需专项审批的活动应在取得审批后方可经营）;策划创意服务;品牌管理
广州市喜满堂娱乐有限公司	歌舞厅娱乐活动;中餐服务;西餐服务;酒店住宿服务（旅业）
北京悦柳恬商贸有限公司广州分公司	技术进出口;货物进出口;出版物零售;网络文化经营
广州流溪文化艺术发展有限公司	文化产业园的投资、招商、开发、建设;文化传播（不含许可经营项目）;博物馆展品、藏品保护的技术研究、技术咨询;会议及展览服务;酒店管理;物业管理;饰物装饰设计服务;展台设计服务;模型设计服务;工艺美术品零售（象牙及其制品除外）;收藏品零售（国家专营专控的除外）
广州播影娱乐传媒有限公司	体育经纪人;文化娱乐经纪人;文艺创作服务;艺（美）术创作服务;艺（美）术装裱、封装服务;艺术表演场馆管理服务;舞台表演艺术指导服务;舞台表演安全保护服务;舞台表演美工服务;舞台表演道具服务;舞台表演化妆服务;舞台灯光、音响设备安装服务;舞台安装、搭建服务;照明灯光设计服务;舞台机械设计安装服务;群众参与的文艺类演出、比赛等公益性文化活动的策划;文化推广（不含许可经营项目）;文化传播（不含许可经营项目）;雕刻艺术创作服务;绘画艺术创作服务;书法篆刻创作服务;具有纪念性建筑物保护的技术研究、技术咨询;具有文化价值遗址保护的技术研究、技术咨询;文物古迹保护的技术研究、技术咨询;传统建筑、历史性建筑保护的技术研究、技术咨询;博物馆展品、藏品保护的技术研究、技术咨询;非物质文化遗产保护的技术研究、技术咨询;艺（美）术品、收藏品鉴定、咨询服务;珠宝鉴定服务;文献书籍修复;演出经纪代理服务;营业性文艺表演
广州御诗文化传播有限公司	文化传播（不含许可经营项目）;文化推广（不含许可经营项目）;群众参与的文艺类演出、比赛等公益性文化活动的策划;舞台表演化妆服务;舞台表演安全保护服务;舞台表演艺术指导服务;艺术表演场馆管理服务;书法篆刻创作服务;绘画艺术创作服务;艺（美）术创作服务;文艺创作服务;教育咨询服务;公司礼仪服务;军事体育拓展训练;体育运动咨询服务;体育营销策划服务;体育组织;竞技体育科技服务;会议及展览服务;大型活动组织策划服务（大型活动指晚会、运动会、庆典、艺术和模特大赛、艺术节、电影节及公益演出、展览等,需专项审批的活动应在取得审批后方可经营）;企业形象策划服务;策划创意服务;市场营销策划服务;商品信息咨询服务;电子商务信息咨询;贸易代理;商品批发贸易（许可审批类商品除外）;商品零售贸易（许可审批类商品除外）;贸易咨询服务;教育评估;办公服务;个人形象设计服务
广州棒棒糖艺术培训有限公司	体育培训;美术辅导服务;舞蹈辅导服务;音乐辅导服务;瑜伽辅导服务;武术辅导服务;戏剧艺术辅导服务;工艺美术辅导服务;表演艺术辅导服务;摄影艺术辅导服务;国学文化推广服务;舞台表演艺术指导服务;文化推广（不含许可经营项目）;文化传播（不含许可经营项目）
广州市金满楼娱乐有限公司	酒店管理;餐饮管理;办公服务;会议及展览服务;咨询策划服务;体验式拓展活动及策划;市场营销策划;食品互联网销售（仅销售预包装食品）;食品销售（仅销售预包装食品）;保健食品（预包装）销售;外卖递送服务;歌舞娱乐活动;住宿服务;酒类经营;烟草制品零售;食品经营（销售散装食品）;餐饮服务
广州浩羽赛鸽有限公司	信鸽销售;牲畜销售;农业科学研究和试验发展;农业机械服务;畜牧机械销售;畜牧渔业饲料销售;畜牧专业及辅助性活动;畜禽粪污处理;与农业生产经营有关的技术、信息、设施建设运营等服务;组织体育表演活动;体育保障组织;健身休闲活动;体育竞赛组织;体育赛事策划;体育用品设备出租;体育用品及器材零售;体育用品及器材批发;体育场地设施工程施工;信鸽养殖;家禽饲养;牲畜饲养
广州市常春藤文化传播有限责任公司	业务培训（不含教育培训、职业技能培训等需取得许可的培训）;体育保障组织;文化场馆管理服务;技术服务、技术开发、技术咨询、技术交流、技术转让、技术推广;法律咨询（不包括律师事务所业务）;项目策划与公关服务;企业形象策划;体验式拓展活动及策划;咨询策划服务;教育咨询服务（不含涉许可审批的教育培训活动）;面向家长实施的家庭教育咨询服务;自费出国留学中介服务;打字复印;图文设计制作;体育赛事策划;文化娱乐经纪人服务;体育经纪人服务;其他文化艺术经纪代理;组织文化艺术交流活动;娱乐性展览;组织体育表演活动;休闲观光活动;游乐园服务;健身休闲活动;体育中介代理服务;体育健康服务;体育竞赛组织;文艺创作;教育教学检测和评价活动;招生辅助服务;中小学生校外托管服务（不含餐饮、住宿、文化教育培训）
广州瑞海文化传媒有限责任公司	电影摄制服务;市场营销策划;企业形象策划;项目策划与公关服务;咨询策划服务;会议及展览服务;专业设计服务;礼仪服务;个人商务服务;广告设计、代理;广告制作;工艺美术品及收藏品批发（象牙及其制品除外）;工艺美术品及收藏品零售（象牙及其制品除外）;日用品批发;日用品销售;日用杂品销售;日用百货销售;办公设备租赁服务;非居住房地产租赁;电子出版物制作;广播电视节目制作经营;信息网络传播视听节目;互联网直播服务（不含新闻信息服务、网络表演、网络视听节目）
广州冬逸电影院有限公司	电影放映;散装食品零售;非酒精饮料及茶叶零售;预包装食品零售;干果、坚果零售;场地租赁（不含仓储）;广告业
广州市从心生活创意文化有限责任公司	文艺创作服务;绘画艺术创作服务;艺（美）术创作服务;向游客提供旅游、交通、住宿、餐饮等代理服务（不涉及旅行社业务）;艺术表演场馆管理服务;舞台安装、搭建服务;具有文化价值遗址保护的技术研究、技术咨询;文物古迹保护的技术研究、技术咨询;传统建筑、历史性建筑保护的技术研究、技术咨询;非物质文化遗产保护的技术研究、技术咨询;群众参与的文艺类演出、比赛等公益性文化活动的策划;文化推广（不含许可经营项目）;文化传播（不含许可经营项目）;教育咨询服务;会议及展览服务;商务咨询服务;企业管理服务（涉及许可经营项目的除外）;企业管理咨询服务;旅游景区规划设计、开发、管理;体育运动咨询服务;体育营销策划服务;体育项目投资与管理;农业技术咨询、交流服务;农产品初加工服务;预包装食品零售
广州市活悦桌球娱乐有限公司	台球服务;棋牌服务;健身服务;运动场馆服务（游泳馆除外）;保健按摩;足疗;预包装食品零售;酒店住宿服务（旅业）
广州胡贝儿文化传播有限公司	群众参与的文艺类演出、比赛等公益性文化活动的策划;会议及展览服务;大型活动组织策划服务（大型活动指晚会、运动会、庆典、艺术和模特大赛、艺术节、电影节及公益演出、展览等,需专项审批的活动应在取得审批后方可经营）;企业形象策划服务;公司礼仪服务;教育咨询服务;产后形体修复咨询服务;化妆品及卫生用品零售;化妆品及卫生用品批发;化妆品批发;化妆品零售;文化艺术咨询服务;策划创意服务;营养健康咨询服务;市场营销策划服务
中农国际文化传播（广州）有限公司	艺术表演场馆管理服务;舞台表演艺术指导服务;舞台表演安全保护服务;舞台表演化妆服务;舞台灯光、音响设备安装服务;舞台安装、搭建服务;照明灯光设计服务;群众参与的文艺类演出、比赛等公益性文化活动的策划;舞台机械设计安装服务;文化推广（不含许可经营项目）;文化传播（不含许可经营项目）;农业项目开发;农业机械服务;农业病虫害防治服务;农业园艺服务;其他农业服务;农业机械租赁;农业工程设计服务;农业规划设计服务;农业技术推广服务;农业技术开发服务;农业技术咨询、交流服务;农业技术转让服务;大型活动组织策划服务（大型活动指晚会、运动会、庆典、艺术和模特大赛、艺术节、电影节及公益演出、展览等,需专项审批的活动应在取得审批后方可经营）;文化娱乐经纪人;模特服务;策划创意服务;企业形象策划服务;市场营销策划服务;公司礼仪服务;摄影服务;个人形象设计服务;公共关系服务;文化艺术咨询服务;项目投资（不含许可经营项目,法律法规禁止经营的项目不得经营）;广告业
广东新新体育产业有限公司	运动场馆服务（游泳馆除外）;投资管理服务;广告业
广州睿熙文化产业发展有限公司	互联网商品零售（许可审批类商品除外）;互联网商品销售（许可审批类商品除外）;商品零售贸易（许可审批类商品除外）;自动售货机、售票机、柜员机及零配件的零售;机械设备租赁;文具用品零售;广告业;艺（美）术创作服务;纸张批发;纸制品零售;收藏品零售（国家专营专控的除外）;集成电路设计;地理信息加工处理;向游客提供旅游、交通、住宿、餐饮等代理服务（不涉及旅行社业务）;美术展览经纪代理服务;网络技术的研究、开发;软件批发;大型活动组织策划服务（大型活动指晚会、运动会、庆典、艺术和模特大赛、艺术节、电影节及公益演出、展览等，需专项审批的活动应在取得审批后方可经营）;通信技术研究开发、技术服务;科技信息咨询服务;投资咨询服务;安全技术防范产品零售;通信设备零售;网络安全信息咨询;信息系统安全服务;软件技术推广服务;网络信息技术推广服务;软件开发;信息系统集成服务;计算机房维护服务;信息技术咨询服务;数据处理和存储服务;房屋建筑工程施工;建筑工程后期装饰、装修和清理;室内装饰、装修;建筑物拆除（不含爆破作业）;提供施工设备服务;土石方工程服务;建筑劳务分包;建筑结构加固补强;建筑结构防水补漏;建筑物电力系统安装;通信线路和设备的安装;广播电视及信号设备的安装;各种交通信号灯及系统安装;雷达、导航与测控系统工程安装服务;监控系统工程安装服务;电子自动化工程安装服务;电子设备工程安装服务;智能化安装工程服务;楼宇设备自控系统工程服务;保安监控及防盗报警系统工程服务;智能卡系统工程服务;通信系统工程服务;卫星及共用电视系统工程服务;计算机网络系统工程服务;广播系统工程服务;消防设施工程专业承包;洁净净化工程设计与施工;门窗安装;工程环保设施施工;工程围栏装卸施工;工程排水施工服务;桩基检测服务;基坑监测服务;基坑支护服务;混凝土切割、钻凿;混凝土泵送;消防安全评估技术服务
广州市新向成月体育文化传播有限公司	文艺创作服务;艺术表演场馆管理服务;舞台表演艺术指导服务;舞台表演安全保护服务;群众参与的文艺类演出、比赛等公益性文化活动的策划;文化推广（不含许可经营项目）;文化传播（不含许可经营项目）;体育组织;健身服务;竞技体育科技服务;全民健身科技服务;体育工程科技服务;市场营销策划服务;体育营销策划服务;美容健身咨询服务;健康管理咨询服务（须经审批的诊疗活动、心理咨询除外,不含许可经营项目,法律法规禁止经营的项目不得经营）;大型活动组织策划服务（大型活动指晚会、运动会、庆典、艺术和模特大赛、艺术节、电影节及公益演出、展览等,需专项审批的活动应在取得审批后方可经营）
广州英豪影视集团有限公司	文艺创作服务;艺（美）术创作服务;艺（美）术装裱、封装服务;艺术表演场馆管理服务;舞台表演艺术指导服务;舞台表演安全保护服务;舞台表演美工服务;舞台表演道具服务;舞台表演化妆服务;舞台灯光、音响设备安装服务;舞台安装、搭建服务;照明灯光设计服务;舞台机械设计安装服务;具有纪念性建筑物保护的技术研究、技术咨询;具有文化价值遗址保护的技术研究、技术咨询;文物古迹保护的技术研究、技术咨询;传统建筑、历史性建筑保护的技术研究、技术咨询;博物馆展品、藏品保护的技术研究、技术咨询;非物质文化遗产保护的技术研究、技术咨询;群众参与的文艺类演出、比赛等公益性文化活动的策划;珠宝鉴定服务;文献书籍修复;档案修复;档案管理服务;档案管理技术服务;档案鉴定;体育经纪人;影视经纪代理服务;音像经纪代理服务;文学、艺（美）术经纪代理服务;美术展览经纪代理服务;动漫（动画）经纪代理服务;公园、景区内游船出租活动;商品批发贸易（许可审批类商品除外）;商品信息咨询服务;商品零售贸易（许可审批类商品除外）;房地产开发经营;自有房地产经营活动;房地产中介服务;房地产咨询服务;房地产估价;房地产投资（不含许可经营项目，法律法规禁止经营的项目不得经营）;物业管理;文化娱乐经纪人;电影和影视节目制作
开合文化（广州）有限公司	个人互联网直播服务（需备案）;艺（美）术品、收藏品鉴定评估服务;文化场馆管理服务;文艺创作;互联网数据服务;网络技术服务;软件开发;信息技术咨询服务;企业管理咨询;企业形象策划;财务咨询;商务代理代办服务;化妆品批发;化妆品零售;网络文化经营;第一类增值电信业务;第二类增值电信业务;基础电信业务;互联网直播服务（不含新闻信息服务、网络表演、网络视听节目）;互联网信息服务
广州市百德文化传播有限责任公司	电影放映;预包装食品零售;糕点、面包零售;非酒精饮料及茶叶零售;散装食品零售;水果零售;小饰物、小礼品零售;礼品鲜花零售;玩具零售
广州古木影视传媒有限公司	电影摄制服务;摄像及视频制作服务;社会经济咨询服务;文化娱乐经纪人服务;体育经纪人服务;其他文化艺术经纪代理;广告设计、代理;广告制作;广告发布（非广播电台、电视台、报刊出版单位）;市场营销策划;项目策划与公关服务;组织文化艺术交流活动;音像制品制作;电影发行;演出经纪; 广播电视节目制作经营
广州市菁木文化传播有限公司	雕刻艺术创作服务;室内手工制作娱乐服务;美术展览经纪代理服务;企业形象策划服务;文化艺术咨询服务;向游客提供旅游、交通、住宿、餐饮等代理服务（不涉及旅行社业务）;会议及展览服务;酒店管理;餐饮管理;信息技术咨询服务;数据处理和存储服务;信息系统集成服务;商品批发贸易（许可审批类商品除外）;互联网商品销售（许可审批类商品除外）;工艺美术品零售
广州萧夏文化发展有限公司	文化场馆管理服务;文艺创作;市场营销策划;企业形象策划;体育赛事策划;咨询策划服务;礼仪服务;会议及展览服务;规划设计管理;广告设计、代理;广告制作;广告发布（非广播电台、电视台、报刊出版单位）;技术服务、技术开发、技术咨询、技术交流、技术转让、技术推广;品牌管理;建筑装饰材料销售;健身休闲活动;休闲观光活动;组织体育表演活动;组织文化艺术交流活动;公园、景区小型设施娱乐活动;租借道具活动;人力资源服务（不含职业中介活动、劳务派遣服务）;体育健康服务;体育中介代理服务;体育竞赛组织;娱乐性展览;其他文化艺术经纪代理;文化娱乐经纪人服务;体育经纪人服务;电影摄制服务;住宅室内装饰装修;歌舞娱乐活动;演出经纪;广播电视节目制作经营;电视剧制作;电子出版物制作
广州武英殿文化传播有限公司	群众参与的文艺类演出、比赛等公益性文化活动的策划;美术展览经纪代理服务;会议及展览服务;个人形象设计服务;大型活动组织策划服务（大型活动指晚会、运动会、庆典、艺术和模特大赛、艺术节、电影节及公益演出、展览等，需专项审批的活动应在取得审批后方可经营）;企业形象策划服务;策划创意服务;文化艺术咨询服务;动漫及衍生产品设计服务;美术图案设计服务;动漫（动画）经纪代理服务;工艺美术品零售;收藏品零售（国家专营专控的除外）;其他文化娱乐用品批发;工艺品批发;美术品批发
葵园文化发展（广州）股份有限公司	咨询策划服务;摄影扩印服务;技术服务、技术开发、技术咨询、技术交流、技术转让、技术推广;工程技术服务（规划管理、勘察、设计、监理除外）;平面设计;专业设计服务;工业设计服务;企业管理咨询;礼仪服务;广告制作;广告发布（非广播电台、电视台、报刊出版单位）;项目策划与公关服务;图文设计制作;广告设计、代理;企业形象策划;市场营销策划;承接总公司工程建设业务;对外承包工程;家用电器安装服务;家具安装和维修服务;电影摄制服务;文化场馆管理服务
广州瑶华圃旅游文化发展有限公司	养老产业投资、开发;养生学的研究开发及技术转让;水果种植;全民健身科技服务;稻谷种植;文化产业园的投资、招商、开发、建设;文化推广（不含许可经营项目）;文化传播（不含许可经营项目）;会议及展览服务;健身服务;向游客提供旅游、交通、住宿、餐饮等代理服务（不涉及旅行社业务）;蔬菜种植;食用菌种植;其他经济作物种植;生态修复的技术研究、开发;中药材种植;农业项目开发;物业管理;水果零售;老年人、残疾人养护服务（不涉及医疗诊断、治疗及康复服务）;其他住宿业;茶馆服务;自助餐服务;中餐服务;酒吧服务;图书馆;酒类批发;民宿服务;预包装食品零售;粮油零售
广州野外露营俱乐部有限公司	露营地服务;健身休闲活动;体育竞赛组织;体验式拓展活动及策划;休闲观光活动;组织体育表演活动;公园、景区小型设施娱乐活动;游乐园服务;停车场服务;商业综合体管理服务;市场营销策划;旅游开发项目策划咨询;餐饮管理;酒店管理;电动汽车充电基础设施运营;非居住房地产租赁;玩具、动漫及游艺用品销售;农副产品销售;户外用品销售
广州喜来畅娱乐有限公司	版权代理;信息技术咨询服务;商务代理代办服务;专业设计服务;工业设计服务;广告设计、代理;文艺创作;数字文化创意软件开发;数字文化创意内容应用服务;日用杂品销售;日用品销售;日用百货销售;保健食品（预包装）销售;食品销售（仅销售预包装食品）;酒吧服务（不含演艺娱乐活动）;酒类经营;烟草制品零售;歌舞娱乐活动;餐饮服务
广州鸿君体育发展有限公司	体育运动咨询服务;体育、休闲娱乐工程设计服务;体育培训;体育组织;竞技体育科技服务;体育工程科技服务;体育器材装备安装服务;体育用品及器材批发;体育用品及器材零售;体育设备、器材出租;体育项目投资与管理;体育营销策划服务;体育赛事运营（涉及许可项目的，需取得许可后方可经营）;企业形象策划服务;策划创意服务;大型活动组织策划服务（大型活动指晚会、运动会、庆典、艺术和模特大赛、艺术节、电影节及公益演出、展览等，需专项审批的活动应在取得审批后方可经营）;会议及展览服务;摄影服务;鞋批发;帽批发;日用器皿及日用杂货批发;玩具批发;办公设备耗材批发;办公设备批发;商品批发贸易（许可审批类商品除外）;商品零售贸易（许可审批类商品除外）
广州东灵尚艺文化传播有限公司	文化传播（不含许可经营项目）;文化推广（不含许可经营项目）;其他文化娱乐用品批发;文具用品零售;文具用品批发;包装材料的销售;乐器批发;乐器零售;乐器维修、调试;货物进出口（专营专控商品除外）;技术进出口;文化艺术咨询服务;中乐器制造;西乐器制造;电子乐器制造;其他乐器及零件制造
广州引擎娱乐有限公司	经营迷你歌咏亭;烟草制品零售;酒类零售;豆制品零售;散装食品零售;糕点、面包零售;餐饮配送服务;甜品制售;预包装食品零售;歌舞厅娱乐活动;酒吧服务;冷热饮品制售;小吃服务;足疗;保健按摩
广州益辉文化有限公司	非居住房地产租赁;贸易经纪;工艺美术品及收藏品批发（象牙及其制品除外）;体育中介代理服务;国内货物运输代理;项目策划与公关服务;体育赛事策划;市场调查（不含涉外调查）;体育用品及器材零售;体育用品及器材批发;艺术品代理;文化场馆管理服务;办公设备销售;咨询策划服务;会议及展览服务
广州市金欢实业投资有限公司	城市绿化管理;创业投资（限投资未上市企业）;机械设备租赁;非居住房地产租赁;物业管理;棋牌室服务;养生保健服务（非医疗）;健身休闲活动;餐饮管理;酒店管理;文化娱乐经纪人服务;洗浴服务;食品经营（销售散装食品）;酒类经营;足浴服务;歌舞娱乐活动
广州珠江在线多媒体信息有限公司	电影摄制服务;会议及展览服务;机械设备租赁;商务代理代办服务;个人商务服务;信息系统集成服务;计算机系统服务;信息技术咨询服务;数据处理和存储支持服务;软件开发;广告制作;广告设计、代理;票务代理服务;体育用品及器材零售;文具用品零售;文具用品批发;日用杂品销售;纸制品销售;乐器零售;照相机及器材销售;玩具销售;互联网销售（除销售需要许可的商品）;服装服饰零售;服装服饰批发;服装辅料销售;美发饰品销售;鞋帽零售;鞋帽批发;箱包销售;新鲜水果批发;新鲜水果零售;化妆品批发;化妆品零售;个人卫生用品销售;消毒剂销售（不含危险化学品）;母婴用品销售;针纺织品销售;非居住房地产租赁;电子、机械设备维护（不含特种设备）;组织文化艺术交流活动;文化娱乐经纪人服务;保健食品（预包装）销售;畜牧渔业饲料销售;饲料添加剂销售;饲料原料销售;生物饲料研发;宠物食品及用品零售;宠物食品及用品批发;第二类医疗器械销售;工艺美术品及礼仪用品销售（象牙及其制品除外）;工艺美术品及收藏品零售（象牙及其制品除外）;食品进出口;珠宝首饰批发;珠宝首饰零售;茶具销售;电池销售;日用口罩（非医用）销售;劳动保护用品销售;金银制品销售;办公用品销售;家用电器销售;家用电器零配件销售;水产品批发;水产品零售;国内贸易代理;灯具销售;办公设备销售;厨具卫具及日用杂品批发;厨具卫具及日用杂品零售;计算机软硬件及辅助设备批发;计算机软硬件及辅助设备零售;网络与信息安全软件开发;专业设计服务;平面设计;广告发布（非广播电台、电视台、报刊出版单位）;对外承包工程;业务培训（不含教育培训、职业技能培训等需取得许可的培训）;网络技术服务;技术服务、技术开发、技术咨询、技术交流、技术转让、技术推广;互联网数据服务;软件销售;其他文化艺术经纪代理;日用百货销售;卫生用品和一次性使用医疗用品销售;服务消费机器人销售;机动车充电销售;电子产品销售;谷物销售;农副产品销售;游艺及娱乐用品销售;广播电视传输设备销售;网络设备销售;室内卫生杀虫剂销售;信息网络传播视听节目;互联网信息服务;免税商店商品销售;广播电视节目制作经营;音像制品制作;电视剧制作;电子出版物制作;电子出版物复制;食品经营（销售散装食品）;食品经营;酒类经营;广播电视视频点播业务;广告发布（广播电台、电视台、报刊出版单位）;饲料生产;饲料添加剂生产;货物进出口;烟草制品零售;食品生产;食用菌菌种经营;广播电视节目传送;各类工程建设活动;建设工程施工;网络文化经营;互联网新闻信息服务
广东开轩文化有限公司	物联网技术研究开发;网络技术的研究、开发;信息系统集成服务;工程和技术基础科学研究服务;信息技术咨询服务;科技中介服务;技术进出口;自有房地产经营活动;房屋租赁;物业管理;文艺创作服务;物联网服务
奥飞动漫文化发展（广州）有限公司	个人互联网直播服务（需备案）;艺（美）术品、收藏品鉴定评估服务;销售代理;票务代理服务;非居住房地产租赁;文化场馆管理服务;企业管理;机械设备销售;日用玻璃制品销售;企业总部管理;服装服饰批发;文具用品批发;日用家电零售;体育用品及器材零售;企业管理咨询;体育场地设施工程施工;玩具制造;国内贸易代理;日用百货销售;市场调查（不含涉外调查）;普通露天游乐场所游乐设备销售;休闲娱乐用品设备出租;互联网销售（除销售需要许可的商品）;软件销售;游乐园服务;文艺创作;自动售货机销售;电子产品销售;广告设计、代理;广告制作;广告发布（非广播电台、电视台、报刊出版单位）;钟表销售;箱包销售;玩具销售;游艺及娱乐用品销售;动漫游戏开发;咨询策划服务;文具用品零售;鞋帽批发;摄影扩印服务;供应链管理服务;餐饮管理;项目策划与公关服务;以自有资金从事投资活动;专业设计服务;其他文化艺术经纪代理;平面设计;针纺织品销售;家居用品销售;美发饰品销售;物业管理;版权代理;玩具、动漫及游艺用品销售;游艺用品及室内游艺器材制造;机械设备租赁;市场营销策划;食品销售（仅销售预包装食品）;对外承包工程;家具安装和维修服务;工程管理服务;营业性演出;游艺娱乐活动;建设工程设计;人防工程设计;文物保护工程设计;专利代理;烟草制品零售;餐饮服务;小餐饮;食品经营（销售散装食品）;食品经营;饮料生产;电影放映;电影发行;广播电视节目制作经营;广播电视视频点播业务;货物进出口;技术进出口;建设工程施工;建筑智能化工程施工;建设工程监理;住宅室内装饰装修
黄埔文化（广州）发展集团有限公司	文艺创作;文物文化遗址保护服务;非物质文化遗产保护;史料、史志编辑服务;个人互联网直播服务（需备案）;文化场馆管理服务;组织文化艺术交流活动;其他文化艺术经纪代理;体育经纪人服务;文化娱乐经纪人服务;体育健康服务;体育中介代理服务;健身休闲活动;电影摄制服务;游览景区管理;名胜风景区管理;城市公园管理;规划设计管理;露营地服务;经营民宿;互联网销售（除销售需要许可的商品）;礼品花卉销售;游艺及娱乐用品销售;旅游开发项目策划咨询;体验式拓展活动及策划;企业管理咨询;礼仪服务;品牌管理;广告制作;以自有资金从事投资活动;项目策划与公关服务;图文设计制作;会议及展览服务;广告设计、代理;体育赛事策划;企业形象策划;市场营销策划;信息咨询服务（不含许可类信息咨询服务）;商业综合体管理服务;园区管理服务;公共事业管理服务;酒店管理;企业管理;文化用品设备出租;休闲娱乐用品设备出租;公园、景区小型设施娱乐活动;艺术品代理;工艺美术品及收藏品零售（象牙及其制品除外）;数字文化创意技术装备销售;广告发布（非广播电台、电视台、报刊出版单位）;租赁服务（不含许可类租赁服务）;娱乐性展览;船舶租赁;非居住房地产租赁;柜台、摊位出租;物业管理;业务培训（不含教育培训、职业技能培训等需取得许可的培训）;咨询策划服务;托育服务;自然遗迹保护管理;农业科学研究和试验发展;土地整治服务;农村民间工艺及制品、休闲农业和乡村旅游资源的开发经营;智能农业管理;农作物秸秆处理及加工利用服务;农业生产托管服务;农业园艺服务;农作物收割服务;农作物栽培服务;农业专业及辅助性活动;农作物病虫害防治服务;灌溉服务;农业机械服务;集贸市场管理服务;营业性演出;演出场所经营;馆藏文物修复、复制、拓印;网络文化经营;广告发布（广播电台、电视台、报刊出版单位）;住宿服务;旅游业务;演出经纪;射击竞技体育运动;电影放映;电影发行;信息网络传播视听节目
广东新中体育集团有限公司	体育用品及器材零售;大型活动组织策划服务（大型活动指晚会、运动会、庆典、艺术和模特大赛、艺术节、电影节及公益演出、展览等,需专项审批的活动应在取得审批后方可经营）;体育器材装备安装服务;体育用品及器材批发;文化艺术咨询服务;竞技体育科技服务;企业形象策划服务;企业管理咨询服务;群众参与的文艺类演出、比赛等公益性文化活动的策划;广告业;体育工程科技服务;全民健身科技服务;运动场馆服务（游泳馆除外）;体育组织;体育运动咨询服务;商品批发贸易（许可审批类商品除外）;互联网商品销售（许可审批类商品除外）;商品零售贸易（许可审批类商品除外）;互联网商品零售（许可审批类商品除外）;非许可类医疗器械经营;广播电视节目制作（具体经营范围以《广播电视节目制作经营许可证》为准）;预包装食品批发;网络销售预包装食品;预包装食品零售;许可类医疗器械经营
广东优创合影文化传播股份有限公司	文艺创作;文化场馆管理服务;版权代理;广告设计、代理;广告制作;广告发布（非广播电台、电视台、报刊出版单位）;会议及展览服务;摄影扩印服务;摄像及视频制作服务;租借道具活动;影视美术道具置景服务;信息技术咨询服务;企业管理咨询;组织文化艺术交流活动;其他文化艺术经纪代理;计算机系统服务;电影摄制服务;音像制品出租;照相器材及望远镜批发;以自有资金从事投资活动;文化娱乐经纪人服务;网络文化经营;货物进出口;广播电视节目制作经营;电影发行;音像制品制作;信息网络传播视听节目;基础电信业务;第二类增值电信业务;第一类增值电信业务;技术进出口
广州澳视互动传媒有限公司	技术进出口;软件开发;电子自动化工程安装服务;电子产品批发;电子、通信与自动控制技术研究、开发;软件批发;货物进出口（专营专控商品除外）;软件零售;信息电子技术服务;商品批发贸易（许可审批类商品除外）;软件服务;计算机网络系统工程服务;网络技术的研究、开发;信息系统集成服务;信息技术咨询服务;物联网技术研究开发;安全技术防范产品制造;安全技术防范系统设计、施工、维修;安全技术防范产品批发;计算机技术开发、技术服务;通信技术研究开发、技术服务;软件测试服务;多媒体设计服务;互联网商品销售（许可审批类商品除外）;互联网商品零售（许可审批类商品除外）;策划创意服务;市场营销策划服务;通信终端设备制造;智能化安装工程服务;影视经纪代理服务;商品零售贸易（许可审批类商品除外）;广告业;通信系统设备制造;光电子器件及其他电子器件制造;企业自有资金投资;电影和影视节目发行;电影和影视节目制作;物联网服务
绿城体育集团股份有限公司	建材、装饰材料批发;其他体育用品制造;运动防护用具制造;体育器材及配件制造;人造纤维编织工艺品制造;室外体育设施工程施工;室内体育场、娱乐设施工程服务;体育运动咨询服务;社区、街心公园、公园等运动场所的管理服务;体育、休闲娱乐工程设计服务;竞技体育科技服务;体育工程科技服务;体育器材装备安装服务;体育用品及器材批发;体育用品及器材零售;货物进出口（专营专控商品除外）;技术进出口;室内装饰、装修;地板制造;塑料人造革、合成革制造;人造纤维（纤维素纤维）制造;橡胶零件制造;运动场馆服务（游泳馆除外）;大型活动组织策划服务（大型活动指晚会、运动会、庆典、艺术和模特大赛、艺术节、电影节及公益演出、展览等,需专项审批的活动应在取得审批后方可经营）;体育设备、器材出租;企业管理咨询服务;信息技术咨询服务;健美运动技术咨询
广州虚拟影业有限公司	动漫及衍生产品设计服务;美术图案设计服务;文化艺术咨询服务;广告业;影视经纪代理服务;文学、艺（美）术经纪代理服务;美术展览经纪代理服务;玩具设计服务;玩具批发;玩具零售;数字动漫制作;软件开发;商品批发贸易（许可审批类商品除外）;商品零售贸易（许可审批类商品除外）;动漫（动画）经纪代理服务;艺（美）术创作服务;电影机械制造;摄影服务电影和影视节目制作;电影和影视节目发行;网上动漫服务;图书批发;音像制品及电子出版物批发;音像制品及电子出版物零售
广东行道天下文化集团有限公司	组织文化艺术交流活动;文化娱乐经纪人服务;文化场馆管理服务;其他文化艺术经纪代理;礼仪服务;娱乐性展览;会议及展览服务;公园、景区小型设施娱乐活动;文艺创作;从事语言能力、艺术、体育、科技等培训的营利性民办培训服务机构（除面向中小学生开展的学科类、语言类文化教育培训）;从事艺术培训的营利性民办培训机构（除面向中小学生开展的学科类、语言类文化教育培训）;从事科技培训的营利性民办培训机构（除面向中小学生开展的学科类、语言类文化教育培训）;组织体育表演活动;项目策划与公关服务;信息技术咨询服务;信息咨询服务（不含许可类信息咨询服务）;以自有资金从事投资活动;企业管理;企业形象策划;体育赛事策划;健身休闲活动;市场营销策划;软件销售;软件开发;咨询策划服务;游艺及娱乐用品销售;影视美术道具置景服务;企业信用管理咨询服务;互联网销售（除销售需要许可的商品）;艺（美）术品、收藏品鉴定评估服务;技术服务、技术开发、技术咨询、技术交流、技术转让、技术推广
广州奥飞硅谷文化发展有限公司	儿童室内游艺厅（室）;演出经纪代理服务;广播电视节目制作（具体经营范围以《广播电视节目制作经营许可证》为准）;电影和影视节目制作;营业性文艺表演;电影和影视节目发行;玩具批发;游艺及娱乐用品批发;玩具零售;数字动漫制作;游戏软件设计制作;商品批发贸易（许可审批类商品除外）;策划创意服务;美术辅导服务;舞蹈辅导服务;音乐辅导服务;个人形象设计服务;票务服务;文学、艺（美）术经纪代理服务;美术展览经纪代理服务;动漫（动画）经纪代理服务;社区、街心公园、公园等运动场所的管理服务;影视经纪代理服务;企业管理咨询服务;企业形象策划服务;会议及展览服务;文化娱乐经纪人;多媒体设计服务;市场调研服务;动漫及衍生产品设计服务;软件开发;自有房地产经营活动;广告业;场地租赁（不含仓储）;舞台表演艺术指导服务;舞台表演美工服务;舞台表演道具服务;文艺创作服务;艺（美）术创作服务;商品零售贸易（许可审批类商品除外）;电子产品设计服务;室内非射击类、非球类、非棋牌类的竞技娱乐活动（不含电子游艺、攀岩、蹦床）;文化艺术咨询服务;表演艺术辅导服务;室内手工制作娱乐服务;艺术表演场馆管理服务;美术图案设计服务;物业管理;房屋租赁;玩具设计服务;群众参与的文艺类演出、比赛等公益性文化活动的策划;大型活动组织策划服务（大型活动指晚会、运动会、庆典、艺术和模特大赛、艺术节、电影节及公益演出、展览等,需专项审批的活动应在取得审批后方可经营）;房地产开发经营
广东正联创意文化传播有限公司	文艺创作;广告设计、代理;广告制作;广告发布（非广播电台、电视台、报刊出版单位）;电子产品销售;电子元器件批发;电力电子元器件销售;电子元器件零售;咨询策划服务;其他文化艺术经纪代理;文化娱乐经纪人服务;信息咨询服务（不含许可类信息咨询服务）;信息技术咨询服务;物联网技术研发;物联网应用服务;物联网技术服务;软件开发;组织文化艺术交流活动;网络技术服务;市场营销策划;会议及展览服务;商务代理代办服务;通信设备销售;计算机软硬件及辅助设备零售;企业管理咨询;厨具卫具及日用杂品批发;厨具卫具及日用杂品零售;日用品销售;日用杂品销售;日用百货销售;化妆品零售;化妆品批发;服装服饰零售;鞋帽零售;日用家电零售;玩具销售;广告发布（广播电台、电视台、报刊出版单位）;基础电信业务;第二类增值电信业务;第一类增值电信业务;呼叫中心;演出经纪;食品互联网销售（销售预包装食品）;食品经营（销售预包装食品）;食品互联网销售（销售预包装食品）;食品互联网销售
广州市建康体育文化发展有限公司	体育用品及器材零售;体育赛事运营（涉及许可项目的,需取得许可后方可经营）;健身服务;体育组织;运动场馆服务（游泳馆除外）;房屋租赁;棋牌服务;体育营销策划服务;物业管理;停车场经营;企业管理服务（涉及许可经营项目的除外）;企业管理咨询服务;工程技术咨询服务;机电设备安装工程专业承包;人力资源管理咨询;会议及展览服务;大型活动组织策划服务（大型活动指晚会、运动会、庆典、艺术和模特大赛、艺术节、电影节及公益演出、展览等,需专项审批的活动应在取得审批后方可经营）;公司礼仪服务;室内装饰、装修;场地租赁（不含仓储）;自有房地产经营活动;游泳馆
广州弘德武术竞技有限公司	竞技体育科技服务;健身服务;全民健身科技服务;体育组织
广州哇嘎文化传媒有限公司	其他文化艺术经纪代理;软件开发;玩具、动漫及游艺用品销售;信息技术咨询服务;动漫游戏开发;数字文化创意软件开发;网络技术服务;第二类增值电信业务;网络文化经营;互联网上网服务;电视剧制作;音像制品制作;电子出版物制作
广州达力动漫有限公司	广播电视节目制作（具体经营范围以《广播电视节目制作经营许可证》为准）;国内广播节目播出服务;国外广播节目播出服务;付费广播节目播出服务;电影和影视节目制作;电影和影视节目发行;网络游戏服务;网上动漫服务;音像制品及电子出版物零售;音像制品及电子出版物批发;电子出版物出版;广告业;电子产品零售;五金产品批发;电子产品批发;游戏软件设计制作;动漫及衍生产品设计服务;电子产品设计服务;数字动漫制作;玩具制造;玩具设计服务;玩具批发;玩具零售;工艺品批发;工艺美术品零售;工艺美术辅导服务;文具用品批发;文具用品零售;文具制造;游艺用品及室内游艺器材制造;塑料制品批发;齿轮及齿轮减、变速箱制造;婴儿用品批发;婴儿用品零售;婴儿推车及其零件制造;家用电器批发;服装批发;技术进出口;体育用品及器材批发;百货零售（食品零售除外）;有机化学原料制造（监控化学品、危险化学品除外）
广州贝肯文化有限公司	文艺创作;组织文化艺术交流活动;其他文化艺术经纪代理;企业形象策划;社会经济咨询服务;专业设计服务;咨询策划服务;玩具、动漫及游艺用品销售;玩具销售;文具用品零售;文具用品批发;体育用品及器材零售;体育用品及器材批发;化妆品零售;化妆品批发;卫生洁具销售;个人卫生用品销售;家居用品销售;服装服饰批发;服装服饰零售;箱包销售;鞋帽零售;鞋帽批发;电子产品销售;文化娱乐经纪人服务;农副产品销售;电影摄制服务;卫生用品和一次性使用医疗用品销售营业性演出;电影发行;广播电视节目制作经营;食品经营（销售预包装食品）;食品经营;酒类经营
鸿潆文化发展（广州）有限公司	文化推广（不含许可经营项目）;文化传播（不含许可经营项目）
广州禾优影业有限公司	电影摄制服务;文艺创作;电视剧制作;电视剧发行;电影发行
广州南华高尔夫俱乐部有限公司	健身服务;高尔夫球场
广州奥飞动漫文化传播有限公司	文化传播（不含许可经营项目）;文化推广（不含许可经营项目）;广告业;商品批发贸易（许可审批类商品除外）;商品零售贸易（许可审批类商品除外）;影视经纪代理服务;音像经纪代理服务;动漫（动画）经纪代理服务;广播电视节目制作（具体经营范围以《广播电视节目制作经营许可证》为准）;电影和影视节目制作;电影和影视节目发行
联通沃音乐文化有限公司	互联网销售（除销售需要许可的商品）;单用途商业预付卡代理销售;咨询策划服务;信息咨询服务（不含许可类信息咨询服务）;版权代理;票务代理服务;组织文化艺术交流活动;项目策划与公关服务;市场营销策划;企业形象策划;其他文化艺术经纪代理;文化娱乐经纪人服务;广告设计、代理;广告制作;广告发布（非广播电台、电视台、报刊出版单位）;网络与信息安全软件开发;网络技术服务;互联网数据服务;数据处理和存储支持服务;数据处理服务;大数据服务;人工智能基础资源与技术平台;图文设计制作;摄像及视频制作服务;动漫游戏开发;数字内容制作服务（不含出版发行）;电子产品销售;通讯设备销售;软件开发;数字文化创意软件开发;人工智能应用软件开发;电子产品销售;集成电路芯片及产品销售;办公设备销售;办公设备耗材销售;办公用品销售;人工智能硬件销售;可穿戴智能设备销售;智能仪器仪表销售;智能家庭消费设备销售;智能无人飞行器销售;智能控制系统集成;日用家电零售;家用电器销售;家居用品销售;家具零配件销售;家用视听设备销售;个人卫生用品销售;卫生洁具销售;汽车装饰用品销售;智能车载设备销售;体育用品及器材批发;游艺及娱乐用品销售;医护人员防护用品批发;卫生用品和一次性使用医疗用品销售;特种劳动防护用品销售;劳动保护用品销售;日用品销售;母婴用品销售;户外用品销售;玩具、动漫及游艺用品销售;工艺美术品及礼仪用品销售（象牙及其制品除外）;文具用品零售;箱包销售;音响设备销售;乐器批发;乐器零售;宠物食品及用品批发;宠物食品及用品零售;鞋帽批发;鞋帽零售;化妆品批发;化妆品零售;食品互联网销售（仅销售预包装食品）;食品销售（仅销售预包装食品）营业性演出;网络文化经营;歌舞娱乐活动;互联网信息服务;第二类增值电信业务;第一类增值电信业务;电子出版物复制;电子出版物制作;出版物互联网销售;互联网新闻信息服务;信息网络传播视听节目;音像制品制作;演出经纪;广播电视节目制作经营
天翼爱音乐文化科技有限公司	文艺创作;组织文化艺术交流活动;社会经济咨询服务;计算机软硬件及辅助设备批发;计算机软硬件及辅助设备零售;计算机系统服务;软件销售;信息安全设备销售;互联网设备销售;网络设备销售;电子产品销售;软件开发;人工智能应用软件开发;网络与信息安全软件开发;人工智能理论与算法软件开发;人工智能基础软件开发;区块链技术相关软件和服务;数字文化创意软件开发;信息系统集成服务;计算机软硬件及外围设备制造;技术服务、技术开发、技术咨询、技术交流、技术转让、技术推广;广告制作;广告发布（非广播电台、电视台、报刊出版单位）;广告设计、代理;机械设备租赁;计算机及通讯设备租赁;销售代理;工艺美术品及收藏品批发（象牙及其制品除外）;工艺美术品及收藏品零售（象牙及其制品除外）;互联网销售（除销售需要许可的商品）;版权代理;知识产权服务;文化娱乐经纪人服务;互联网数据服务;数据处理和存储支持服务;会议及展览服务;信息技术咨询服务;信息咨询服务（不含许可类信息咨询服务）;网络技术服务;专业设计服务;通信设备销售;物联网技术研发;物联网应用服务;物联网技术服务;以自有资金从事投资活动;第一类增值电信业务;第二类增值电信业务;营业性演出;演出经纪;技术进出口;出版物互联网销售;信息网络传播视听节目;电子出版物制作;广播电视节目制作经营;电子出版物复制
广州市土星文化发展有限公司	文艺创作;工艺美术品及礼仪用品制造（象牙及其制品除外）;玩具制造;教学用模型及教具制造;五金产品制造;五金产品零售;金属制品销售;玩具、动漫及游艺用品销售;电子产品销售;教学用模型及教具销售;玩具销售;工艺美术品及收藏品零售（象牙及其制品除外）;工艺美术品及收藏品批发（象牙及其制品除外）;休闲娱乐用品设备出租;文化用品设备出租;教育咨询服务（不含涉许可审批的教育培训活动）;互联网销售（除销售需要许可的商品）;网络技术服务;模具制造;模具销售;通用设备制造（不含特种设备制造）;专用设备制造（不含许可类专业设备制造）;货物进出口
广州长长影视文化有限公司	电影和影视节目制作;电影和影视节目发行;录音制作;音像制品及电子出版物批发;音像制品及电子出版物零售;广播节目制作;音像制品出版;电影放映;信息网络传播视听节目业务;演出经纪代理服务;影视经纪代理服务;音像经纪代理服务;文学、艺（美）术经纪代理服务;文化娱乐经纪人;文化艺术咨询服务;模特服务;个人形象设计服务;大型活动组织策划服务;文艺创作服务;艺（美）术创作服务;舞台表演艺术指导服务;舞台表演美工服务;舞台表演道具服务;舞台表演化妆服务;广告业;企业形象策划服务;投资管理服务;会议及展览服务;音像制品出租;动漫（动画）经纪代理服务
广州华蒙星体育发展有限公司	体育组织;体育用品及器材批发;体育用品及器材零售;体育运动咨询服务;体育培训;大型活动组织策划服务（大型活动指晚会、运动会、庆典、艺术和模特大赛、艺术节、电影节及公益演出、展览等,需专项审批的活动应在取得审批后方可经营）;教育咨询服务;文化艺术咨询服务;全民健身科技服务;运动场馆服务（游泳馆除外）;体育经纪人;体育赛事运营（涉及许可项目的,需取得许可后方可经营）;健康管理咨询服务（须经审批的诊疗活动、心理咨询除外,不含许可经营项目,法律法规禁止经营的项目不得经营）
广州一森文化股份有限公司	文艺创作服务;企业管理咨询服务;企业形象策划服务;会议及展览服务;舞台表演艺术指导服务;舞台表演安全保护服务;舞台表演美工服务;舞台表演道具服务;舞台表演化妆服务;舞台灯光、音响设备安装服务;网络技术的研究、开发;演出经纪代理服务
广东蓝火互动传媒有限公司	摄影服务;纺织品、针织品及原料批发;服装辅料批发;头饰批发;鞋批发;家用电器批发;钟表批发;眼镜批发;家具批发;婴儿用品批发;钻石饰品批发;网络技术的研究、开发;化妆品及卫生用品批发;化妆品及卫生用品零售;群众参与的文艺类演出、比赛等公益性文化活动的策划;市场营销策划服务;商品信息咨询服务;影视经纪代理服务;电子产品设计服务;鞋设计;会议及展览服务;教育咨询服务;家居饰品批发;服装批发;服装零售;舞台表演美工服务;舞台表演道具服务;舞台表演化妆服务;舞台灯光、音响设备安装服务;舞台安装、搭建服务;信息技术咨询服务;计算机技术开发、技术服务;珠宝鉴定服务;文化娱乐经纪人;体育经纪人;文学、艺（美）术经纪代理服务;美术展览经纪代理服务;动漫（动画）经纪代理服务;艺（美）术创作服务;艺术表演场馆管理服务;包装装潢设计服务;多媒体设计服务;动漫及衍生产品设计服务;饰物装饰设计服务;广告业;文艺创作服务;音像经纪代理服务;展台设计服务;模型设计服务;美术图案设计服务;家具设计服务;珠宝首饰设计服务;照明灯光设计服务;社会人文科学研究;工业设计服务;时装设计服务;游艺及娱乐用品批发;其他文化娱乐用品批发;宝石饰品批发;玉石饰品批发;水晶首饰批发;收藏品批发（国家专营专控的除外）;珍珠饰品批发;其他人造首饰、饰品批发;互联网商品销售（许可审批类商品除外）;预包装食品批发;预包装食品零售;酒类批发;酒类零售
广州市奥冠体育发展有限公司	游泳馆;预包装食品零售;体育组织;大型活动组织策划服务（大型活动指晚会、运动会、庆典、艺术和模特大赛、艺术节、电影节及公益演出、展览等,需专项审批的活动应在取得审批后方可经营）;健身服务;场地租赁（不含仓储）;商品批发贸易（许可审批类商品除外）;体育器材装备安装服务;体育用品及器材批发;广告业;体育运动咨询服务;体育经纪人;室内体育场、娱乐设施工程服务;室外体育设施工程施工;娱乐设备出租服务;体育用品及器材零售;运动场馆服务（游泳馆除外）;体育培训;代售福利彩票、体育彩票;艺术表演场馆管理服务;体育、休闲娱乐工程设计服务;社区、街心公园、公园等运动场所的管理服务;停车场经营
美妆头条传媒（广州）有限公司	计算机技术开发、技术服务;网络技术的研究、开发;软件开发;信息技术咨询服务;会议及展览服务;广告业;大型活动组织策划服务（大型活动指晚会、运动会、庆典、艺术和模特大赛、艺术节、电影节及公益演出、展览等,需专项审批的活动应在取得审批后方可经营）;商品批发贸易（许可审批类商品除外）;商品零售贸易（许可审批类商品除外）;文化推广（不含许可经营项目）;文化传播（不含许可经营项目）;电子出版物出版;音像制品出版;期刊出版;报纸出版;图书出版;互联网出版业;广播电视节目制作（具体经营范围以《广播电视节目制作经营许可证》为准）;国内广播节目播出服务;国外广播节目播出服务;付费广播节目播出服务
广东唐三藏文化传媒有限公司	文艺创作服务;宝石饰品零售;玉石饰品零售;水晶饰品零售;投资咨询服务;珍珠饰品零售;其他人造首饰、饰品零售;艺（美）术品、收藏品鉴定、咨询服务;白银制品零售;国学文化推广服务;向游客提供旅游、交通、住宿、餐饮等代理服务（不涉及旅行社业务）;文化娱乐经纪人;信息技术咨询服务;珠宝鉴定服务;数据处理和存储服务;工艺美术品零售;酒店管理;餐饮管理;企业管理咨询服务;企业形象策划服务;软件开发;策划创意服务;群众参与的文艺类演出、比赛等公益性文化活动的策划;钻石首饰零售;预包装食品零售;自助餐服务;中餐服务;西餐服务
广州市菁蜜千名文化传媒有限公司	信息网络传播视听节目业务;文艺创作服务;音像经纪代理服务;影视经纪代理服务;文化娱乐经纪人;文化艺术咨询服务;文学、艺（美）术经纪代理服务;公司礼仪服务;公共关系服务;策划创意服务;会议及展览服务;企业形象策划服务;群众参与的文艺类演出、比赛等公益性文化活动的策划;大型活动组织策划服务（大型活动指晚会、运动会、庆典、艺术和模特大赛、艺术节、电影节及公益演出、展览等，需专项审批的活动应在取得审批后方可经营）;广告业;个人形象设计服务;企业管理服务（涉及许可经营项目的除外）;企业管理咨询服务;投资咨询服务;投资管理服务;商品零售贸易（许可审批类商品除外）;商品批发贸易（许可审批类商品除外）;互联网商品销售（许可审批类商品除外）;网络技术的研究、开发;计算机技术开发、技术服务;软件开发;软件服务
广州市锐丰文化传播有限公司	日用家电设备零售;文化艺术咨询服务;群众参与的文艺类演出、比赛等公益性文化活动的策划;灯光设备租赁;舞台灯光、音响设备安装服务;体育赛事运营（涉及许可项目的,需取得许可后方可经营）;体育运动咨询服务;体育项目投资与管理;大型活动组织策划服务（大型活动指晚会、运动会、庆典、艺术和模特大赛、艺术节、电影节及公益演出、展览等,需专项审批的活动应在取得审批后方可经营）;广告业;文艺创作服务;音频和视频设备租赁;家用视听设备零售;运动场馆服务（游泳馆除外）;社区、街心公园、公园等运动场所的管理服务;物业管理;场地租赁（不含仓储）;体育设备、器材出租;艺（美）术创作服务;舞台安装、搭建服务;照明灯光设计服务;会议及展览服务;策划创意服务;家用电器批发;货物进出口（专营专控商品除外）;演出经纪代理服务;营业性文艺表演;食品经营（销售散装食品）
广州同欣体育股份有限公司	健身休闲活动;体育用品制造;橡胶制品制造;塑料制品制造;体育用品及器材零售;体育用品及器材批发;体育场地设施工程施工;橡胶加工专用设备制造;橡胶加工专用设备销售;橡胶制品销售;塑料制品销售;机械设备租赁;技术服务、技术开发、技术咨询、技术交流、技术转让、技术推广;货物进出口;技术进出口
唐影集团股份有限公司	电影摄制服务;电影制片;其他文化艺术经纪代理;文化娱乐经纪人服务;组织文化艺术交流活动;企业形象策划;项目策划与公关服务;广告制作;文物文化遗址保护服务;非物质文化遗产保护;艺（美）术品、收藏品鉴定评估服务;个人互联网直播服务（需备案）;文化场馆管理服务;体育竞赛组织;教育教学检测和评价活动;摄像及视频制作服务;宠物服务（不含动物诊疗）;自然遗迹保护管理;植物园管理服务;大气污染治理;森林公园管理;酒店管理;包装服务;办公服务;品牌管理;旅游开发项目策划咨询;物业管理;创业投资（限投资未上市企业）;艺术品代理;宗教场所用品销售;影视美术道具置景服务;航空商务服务;动漫游戏开发;企业管理咨询;个人商务服务;园区管理服务;企业管理;音像制品出租;专业设计服务;新材料技术研发;咨询策划服务;礼仪服务;特种作业人员安全技术培训;养老服务;健身休闲活动;休闲观光活动;租借道具活动;娱乐性展览;文艺创作;礼仪服务;商务秘书服务;市场主体登记注册代理;图文设计制作;船舶租赁;家宴服务;机动车修理和维护;露营地服务;广播电视节目制作经营;电影发行;电影放映
广州足球俱乐部股份有限公司	体育组织;运动场馆服务（游泳馆除外）;体校及体育培训;群众参与的文艺类演出、比赛等公益性文化活动的策划;策划创意服务;商品批发贸易（许可审批类商品除外）;商品零售贸易（许可审批类商品除外）;广告业
广东新诺影业集团有限公司	电影和影视节目制作;电影放映;营业性文艺表演;演出经纪代理服务;录音制作;国内广播节目播出服务;信息网络传播视听节目业务;广播节目制作;电影和影视节目发行;舞台表演安全保护服务;艺术表演场馆管理服务;音像经纪代理服务;文化娱乐经纪人;舞台表演道具服务;艺（美）术创作服务;舞台表演化妆服务;文艺创作服务;舞台表演美工服务;舞台灯光、音响设备安装服务;动漫（动画）经纪代理服务;舞台表演艺术指导服务
广东龙达影业股份有限公司	音像经纪代理服务;文学、艺（美）术经纪代理服务;技术进出口;影视经纪代理服务;企业管理咨询服务;企业形象策划服务;文化娱乐经纪人;展台设计服务;舞台表演艺术指导服务;文艺创作服务;艺（美）术创作服务;货物进出口（专营专控商品除外）;娱乐设备出租服务;广告业;信息网络传播视听节目业务;演出经纪代理服务;广播电视节目制作（具体经营范围以《广播电视节目制作经营许可证》为准）;电影和影视节目制作;电影放映;录音制作;国内广播节目播出服务;付费广播节目播出服务;营业性文艺表演;电影和影视节目发行;国外广播节目播出服务
广州津虹网络传媒有限公司	企业形象策划;项目策划与公关服务;咨询策划服务;版权代理;市场调查（不含涉外调查）;软件开发;广告设计、代理;广告制作;市场营销策划;艺术品代理;出版物批发;出版物零售;网络文化经营;音像制品制作;信息网络传播视听节目;广播电视节目制作经营;第二类增值电信业务;第一类增值电信业务;拍卖业务;二手车拍卖
广州市澳源科技集团有限公司	文艺创作服务;企业管理咨询服务;商品信息咨询服务;企业形象策划服务;市场营销策划服务;广告业;软件开发;信息技术咨询服务;数据处理和存储服务
逸雅楼文化（广东）集团有限公司	文艺创作服务;绘画艺术创作服务;书法篆刻创作服务;艺（美）术装裱、封装服务;艺术表演场馆管理服务;舞台表演美工服务;文物古迹保护的技术研究、技术咨询;具有文化价值遗址保护的技术研究、技术咨询;传统建筑、历史性建筑保护的技术研究、技术咨询;文献书籍修复;收藏品的修复、养护服务;艺（美）术品、收藏品鉴定、咨询服务;美术辅导服务;舞蹈辅导服务;音乐辅导服务;工艺美术辅导服务;商品批发贸易（许可审批类商品除外）;商品零售贸易（许可审批类商品除外）
广州中喜文化有限公司	艺（美）术创作服务;企业管理咨询服务;投资管理服务;广告业;票务服务;场地租赁（不含仓储）;预包装食品批发;预包装食品零售
广州五百丁信息科技有限公司	食品互联网销售（仅销售预包装食品）;食品销售（仅销售预包装食品）;外卖递送服务;信息技术咨询服务;信息系统集成服务;人力资源服务（不含职业中介活动、劳务派遣服务）;广告发布（非广播电台、电视台、报刊出版单位）;软件开发;酒吧服务（不含演艺娱乐活动）;小餐饮;餐饮服务;职业中介活动
飞立洋（广州）影视文化发展有限公司	文艺创作服务;文化传播（不含许可经营项目）;舞台表演艺术指导服务;舞台灯光、音响设备安装服务;舞台安装、搭建服务;舞台机械设计安装服务;文化推广（不含许可经营项目）;灯光设备租赁;音频和视频设备租赁;商品批发贸易（许可审批类商品除外）;商品零售贸易（许可审批类商品除外）;电视设备及其配件批发;电子产品批发;电子产品零售;专用设备销售
广东半度控股有限公司	文艺创作;电影摄制服务;文化娱乐经纪人服务;其他文化艺术经纪代理;公园、景区小型设施娱乐活动;租借道具活动;娱乐性展览;招生辅助服务;家宴服务;摄影扩印服务;婚庆礼仪服务;摄像及视频制作服务;专业设计服务;规划设计管理;技术服务、技术开发、技术咨询、技术交流、技术转让、技术推广;咨询策划服务;影视美术道具置景服务;平面设计;工业设计服务;3D打印服务;知识产权服务;创业空间服务;服饰研发;物联网技术研发;服装服饰出租;计算机及通讯设备租赁;办公设备租赁服务;休闲娱乐用品设备出租;体育用品设备出租;文化用品设备出租;音像制品出租;电子出版物出租;企业管理咨询;体验式拓展活动及策划;凭总公司授权开展经营活动;商业综合体管理服务;体育赛事策划;采购代理服务;企业形象策划;办公服务;企业总部管理;财务咨询;会议及展览服务;包装服务;图文设计制作;打字复印;翻译服务;项目策划与公关服务;社会调查（不含涉外调查）;广告发布（非广播电台、电视台、报刊出版单位）;广告制作;招投标代理服务;政府采购代理服务;品牌管理;服装、服饰检验、整理服务;商务秘书服务;劳务服务（不含劳务派遣）;融资咨询服务;礼仪服务;企业管理;信息咨询服务（不含许可类信息咨询服务）;市场营销策划;教育咨询服务（不含涉许可审批的教育培训活动）;广告设计、代理;物业管理;住房租赁;房地产经纪;房地产咨询;柜台、摊位出租;互联网数据服务;数字文化创意内容应用服务;物联网应用服务;大数据服务;信息系统集成服务;数据处理和存储支持服务;人工智能基础软件开发;数字内容制作服务（不含出版发行）;人工智能通用应用系统;网络技术服务;人工智能公共服务平台技术咨询服务;软件开发;人工智能基础资源与技术平台;人工智能应用软件开发;软件外包服务;网络与信息安全软件开发;数字文化创意软件开发;智能控制系统集成;物联网技术服务;信息系统运行维护服务;信息技术咨询服务;数据处理服务;动漫游戏开发;计算机系统服务;旅客票务代理;日用家电零售;计算机软硬件及辅助设备零售;通讯设备销售;体育经纪人服务;;营业性演出;广播电视节目制作经营;电影发行;网络文化经营;演出经纪;互联网上网服务;建设工程设计;房地产开发经营;药品互联网信息服务;互联网直播服务（不含新闻信息服务、网络表演、网络视听节目）;演出场所经营;歌舞娱乐活动;音像制品制作;电子出版物制作
广东动的文化发展（集团）有限公司	文化推广（不含许可经营项目）;酒店管理;文化艺术咨询服务;策划创意服务;投资咨询服务;房地产投资（不含许可经营项目,法律法规禁止经营的项目不得经营）;餐饮管理;企业管理服务（涉及许可经营项目的除外）;供应链管理;企业管理咨询服务;养老产业投资、开发;体育项目投资与管理;投资、开发、建设、经营管理物流设施;项目投资（不含许可经营项目,法律法规禁止经营的项目不得经营）;文艺创作服务
广州影行天下文化传播有限公司	舞台机械设计安装服务;策划创意服务;互联网商品销售（许可审批类商品除外）;群众参与的文艺类演出、比赛等公益性文化活动的策划;新闻业;多媒体设计服务;广播电视节目制作（具体经营范围以《广播电视节目制作经营许可证》为准）;电影和影视节目制作;音像制品制作;电影和影视节目发行;音像制品出版;电子出版物出版;图书出版;报纸出版;期刊出版;电影放映;信息网络传播视听节目业务;录音制作;赛事转播服务
齐籍堂文化艺术发展（广州）有限责任公司	文艺创作服务;艺（美）术创作服务;广告业;旅游景区规划设计、开发、管理;数字动漫制作;体育经纪人;艺术表演场馆管理服务;舞台表演艺术指导服务;翻译服务;美术图案设计服务;会议及展览服务;企业形象策划服务;公司礼仪服务;摄影服务
广东乐佳印刷有限公司	纸张批发;广告业;印刷技术开发;包装装潢印刷品印刷;除出版物、包装装潢印刷品之外的其他印刷品印刷;图书出版
广州星海传媒有限公司	广告业;软件开发;计算机技术开发、技术服务;软件零售;计算机及通讯设备租赁;自有设备租赁（不含许可审批项目）;信息网络传播视听节目业务;电影和影视节目发行;广播电视节目制作（具体经营范围以《广播电视节目制作经营许可证》为准）;电影和影视节目制作
广东云股传媒股份有限公司	企业总部管理;文化艺术咨询服务;策划创意服务;商品信息咨询服务;广告业;企业自有资金投资;大型活动组织策划服务（大型活动指晚会、运动会、庆典、艺术和模特大赛、艺术节、电影节及公益演出、展览等，需专项审批的活动应在取得审批后方可经营）;软件服务;视频设备出租服务;移民咨询服务（不含就业、留学咨询）;文化娱乐经纪人;商品批发贸易（许可审批类商品除外）;商品零售贸易（许可审批类商品除外）;软件批发;软件零售;软件开发;软件技术推广服务;计算机硬件的研究、开发;信息系统集成服务;专用设备安装（电梯、锅炉除外）;专用设备销售;货物进出口（专营专控商品除外）;技术进出口;音像制品制作
广州希界维影城有限公司	休闲娱乐用品设备出租;化妆品零售;个人卫生用品销售;工艺美术品及收藏品零售（象牙及其制品除外）;信息咨询服务（不含许可类信息咨询服务）;企业管理;会议及展览服务;广告设计、代理;广告发布（非广播电台、电视台、报刊出版单位）;非居住房地产租赁;日用百货销售;家用电器销售;玩具销售;珠宝首饰零售;服装服饰零售;箱包销售;文具用品零售;办公用品销售;体育用品及器材零售;礼品花卉销售;眼镜销售（不含隐形眼镜）;组织文化艺术交流活动;剧本娱乐活动;电影放映;餐饮服务;食品经营;演出场所经营
广州魁钺会文化传播有限公司	文艺创作;信息技术咨询服务;互联网销售（除销售需要许可的商品）;会议及展览服务;企业形象策划;网络技术服务;其他文化艺术经纪代理;文化娱乐经纪人服务;礼仪服务;市场营销策划;咨询策划服务;软件开发;企业管理咨询;电影摄制服务;广告制作;摄像及视频制作服务;化妆品零售;化妆品批发;计算机系统服务;信息系统集成服务;技术服务、技术开发、技术咨询、技术交流、技术转让、技术推广;互联网销售（除销售需要许可的商品）;品牌管理;演出经纪;电影放映;电影发行;广播电视节目制作经营;电视剧制作;保健食品销售;食品经营（销售预包装食品）;食品互联网销售（销售预包装食品）;食品经营;食品经营（销售散装食品）
广州鼎梵数码科技有限公司	文艺创作服务;软件开发;信息技术咨询服务;数据处理和存储服务;集成电路设计;数字内容服务;多媒体设计服务;美术图案设计服务;文学、艺（美）术经纪代理服务;网络技术的研究、开发;信息系统集成服务;电气设备批发;软件批发;电子元器件批发;电子产品批发;技术进出口;贸易代理;工艺品批发;美术品批发;计算机批发;计算机零配件批发;商品批发贸易（许可审批类商品除外）;家用视听设备零售;日用家电设备零售;计算机零售;计算机零配件零售;软件零售;增值电信服务（业务种类以《增值电信业务经营许可证》载明内容为准）;网络音乐服务;网上图片服务;网上新闻服务;网络游戏服务;网上电影服务;网上动漫服务;网上读物服务;网上视频服务;图书批发;音像制品及电子出版物批发;报刊批发
广州十九号动漫文化有限公司	动漫游戏开发;玩具、动漫及游艺用品销售;玩具销售;娱乐性展览;玩具制造;电影摄制服务;摄像及视频制作服务;数字内容制作服务（不含出版发行）;专业设计服务;信息技术咨询服务;信息咨询服务（不含许可类信息咨询服务）;文艺创作;广告制作;广告设计、代理;平面设计;图文设计制作;工业设计服务;互联网数据服务;网络技术服务;软件外包服务;数字文化创意软件开发;广播电视节目制作经营
广州迅视影视传媒有限公司	文化艺术咨询服务;文化研究;群众参与的文艺类演出、比赛等公益性文化活动的策划;文化推广（不含许可经营项目）;文化传播（不含许可经营项目）;大型活动组织策划服务（大型活动指晚会、运动会、庆典、艺术和模特大赛、艺术节、电影节及公益演出、展览等,需专项审批的活动应在取得审批后方可经营）;舞台表演艺术指导服务;企业形象策划服务;策划创意服务;市场营销策划服务;文艺创作服务;会议及展览服务;摄影服务;翻译服务;舞台表演道具服务;舞台灯光、音响设备安装服务;舞台机械设计安装服务;体育设备、器材出租;服装和鞋帽出租服务;道具出租服务;音频和视频设备租赁;电影和影视节目发行;电影和影视节目制作;付费广播节目播出服务;广播电视节目制作（具体经营范围以《广播电视节目制作经营许可证》为准）;营业性文艺表演
芈星（广州）文化传媒有限公司	礼仪服务;广告发布（非广播电台、电视台、报刊出版单位）;广告制作;图文设计制作;广告设计、代理;市场调查（不含涉外调查）;市场营销策划;会议及展览服务;企业形象策划;技术服务、技术开发、技术咨询、技术交流、技术转让、技术推广;针纺织品销售;服装服饰零售;鞋帽零售;化妆品零售;化妆品批发;眼镜销售（不含隐形眼镜）;箱包销售;针纺织品及原料销售;钟表销售;厨具卫具及日用杂品零售;日用杂品销售;文具用品零售;文具用品批发;美发饰品销售;珠宝首饰零售;玩具销售;灯具销售;咨询策划服务;网络技术服务;组织文化艺术交流活动;个人卫生用品销售;宠物食品及用品零售;医用口罩零售;日用家电零售;广告发布（广播电台、电视台、报刊出版单位）;演出经纪;广播电视节目制作经营
广东德谷文化有限公司	雕刻艺术创作服务;档案鉴定;档案管理技术服务;档案管理服务;档案修复;文献书籍修复;珠宝鉴定服务;传统建筑、历史性建筑保护的技术研究、技术咨询;具有文化价值遗址保护的技术研究、技术咨询;具有纪念性建筑物保护的技术研究、技术咨询;艺（美）术装裱、封装服务;绘画艺术创作服务;艺（美）术品、收藏品鉴定、咨询服务;收藏品的修复、养护服务;文物古迹保护的技术研究、技术咨询;博物馆展品、藏品保护的技术研究、技术咨询;收购古旧书籍、碑帖、拓本、字画等工艺美术品（文物除外，法律禁止经营的不得经营，涉及许可证的凭许可证经营）;珠宝玉石检测服务;玉石饰品批发;玉石饰品零售;收藏品批发（国家专营专控的除外）;收藏品零售（国家专营专控的除外）;珍珠饰品批发;珍珠饰品零售;工艺美术品零售（象牙及其制品除外）;美术展览经纪代理服务;宝石饰品批发;宝石饰品零售;钻石饰品批发;钻石销售;钻石首饰零售;工艺品批发（象牙及其制品除外）;文学、艺（美）术经纪代理服务;货物进出口（专营专控商品除外）;集邮品批发和进出口;茶叶作物及饮料作物批发;白银制品批发;白银制品零售;文化艺术咨询服务;技术进出口;黄金制品批发;经政府有关部门授权，从事罚没物资、假冒商品的销毁;拆解、回收利用罚没物资及查处的假冒商品;企业产权交易的受托代理;土地评估;美术品批发（象牙及其制品除外）;美术馆;展览馆;进出口商品检验鉴定（具体经营项目以《进出口商品检验鉴定机构资格证书》载明为准）;现金、有价证券、重要凭证、金银珠宝、文物等及其它贵重物品的武装守护、押运;文物经营;宝石、玉石采选;出版物进口经营;拍卖
广州市安创文化传播有限公司	露天游乐场所游乐设备制造;玩具制造;民间工艺品制造（象牙及其制品除外）;金属工艺品制造;花画工艺品制造;游艺用品及室内游艺器材制造;雕塑工艺品制造（象牙及其制品除外）;雕刻艺术创作服务;工艺美术品零售（象牙及其制品除外）;美术品批发（象牙及其制品除外）;广告业;会议及展览服务;风景园林工程设计服务;企业形象策划服务;路牌、路标、广告牌安装施工;标识、标志牌设计、安装服务;房屋建筑工程施工;室内体育场、娱乐设施工程服务;室外体育设施工程施工;室外娱乐用设施工程施工;文化艺术咨询服务;文艺创作服务;艺（美）术创作服务;艺（美）术装裱、封装服务;3D扫描及打印设备的制造;标识、标志牌制造;灯具、装饰物品批发;多媒体设计服务;风景园林工程的技术研究、开发;工程和技术研究和试验发展;工程环保设施施工;工程施工总承包;公园规划设计;家居饰品批发;家具批发;家具零售;家具设计服务;建材、装饰材料批发;建筑工程、土木工程技术服务;建筑工程后期装饰、装修和清理;建筑劳务分包;金属切割及焊接设备制造;金属装饰材料零售;景观和绿地设施工程设计服务;景观和绿地设施工程施工;旅游景区规划设计、开发、管理;美术图案设计服务;美术展览经纪代理服务;模型设计服务;商品零售贸易（许可审批类商品除外）;商品批发贸易（许可审批类商品除外）;市政工程设计服务;市政公用工程施工;室内装饰、装修;室内装饰设计服务;收藏品零售（国家专营专控的除外）;收藏品批发（国家专营专控的除外）;数字动漫制作;销售标识牌、指示牌;艺（美）术品、收藏品鉴定、咨询服务;园林绿化工程服务;照明灯光设计服务;大型活动组织策划服务（大型活动指晚会、运动会、庆典、艺术和模特大赛、艺术节、电影节及公益演出、展览等，需专项审批的活动应在取得审批后方可经营）;露天游乐场所游乐设施零售;露天游乐场所游乐设施批发
广东合祥影视有限公司	文艺创作服务;影视经纪代理服务;舞台表演艺术指导服务;文化娱乐经纪人;企业自有资金投资;项目投资（不含许可经营项目，法律法规禁止经营的项目不得经营）;企业管理咨询服务;企业管理服务（涉及许可经营项目的除外）;商品信息咨询服务;个人形象设计服务;展台设计服务;软件开发;软件服务;软件测试服务;信息技术咨询服务;网络技术的研究、开发;文化艺术咨询服务;文化产业园的投资、招商、开发、建设;电影和影视节目制作;录音制作;电影放映;电影和影视节目发行;营业性文艺表演;演出经纪代理服务
广州欢聚传媒有限公司	电影和影视节目制作;付费广播节目播出服务;图书批发;信息网络传播视听节目业务;录音制作;咖啡馆服务;网络音乐服务;演出经纪代理服务;国内广播节目播出服务;图书、报刊零售;国外广播节目播出服务;电影和影视节目发行;小型综合商店、小卖部;广播节目制作;图书出版;商品批发贸易（许可审批类商品除外）;数字动漫制作;音乐辅导服务;音像经纪代理服务;文化娱乐经纪人;小饰物、小礼品零售;票务服务;游戏设计制作;影视经纪代理服务
广州市金科物业租赁有限公司	物业管理;商业综合体管理服务;非居住房地产租赁;信息咨询服务（不含许可类信息咨询服务）;停车场服务;餐饮管理;广告设计、代理;广告发布（非广播电台、电视台、报刊出版单位）;广告制作
广州市番禺祈福新邨渡假俱乐部有限公司	百货零售（食品、烟草制品零售除外）;停车场经营;竞技体育科技服务;运动场馆服务（游泳馆除外）;台球服务;洗衣服务;飞镖服务;棋牌服务;健身服务;向游客提供旅游、交通、住宿、餐饮等代理服务（不涉及旅行社业务）;盲人按摩;全民健身科技服务;物业管理;场地租赁（不含仓储）;会议及展览服务;保龄球服务;射箭馆场服务;图书馆;西餐服务;歌舞厅娱乐活动;游泳馆;潜水;儿童室内游艺厅（室）;足疗;电子游艺厅娱乐活动;攀岩;美容服务;中餐服务;糕点、面包零售
广东美丽世界赛事管理有限公司	体育组织;旅游景区规划设计、开发、管理;企业形象策划服务;个人形象设计服务;体育运动咨询服务;体育营销策划服务;大型活动组织策划服务（大型活动指晚会、运动会、庆典、艺术和模特大赛、艺术节、电影节及公益演出、展览等，需专项审批的活动应在取得审批后方可经营）;体育赛事运营（涉及许可项目的，需取得许可后方可经营）;模特服务;运动场馆服务（游泳馆除外）;健身服务;保龄球服务;台球服务;棋牌服务;射箭馆场服务;竞技体育科技服务;全民健身科技服务;体育工程科技服务;体育器材装备安装服务;社区、街心公园、公园等运动场所的管理服务;文化娱乐经纪人;体育经纪人;影视经纪代理服务;音像经纪代理服务;文学、艺（美）术经纪代理服务;美术展览经纪代理服务;动漫（动画）经纪代理服务;文艺创作服务;艺（美）术创作服务;艺（美）术装裱、封装服务;艺术表演场馆管理服务;舞台表演艺术指导服务;舞台表演安全保护服务;舞台表演美工服务;舞台表演道具服务;群众参与的文艺类演出、比赛等公益性文化活动的策划;文化艺术咨询服务;舞台安装、搭建服务;体育项目投资与管理;舞台灯光、音响设备安装服务;舞台表演化妆服务;照明灯光设计服务;电影和影视节目制作
优象文化（广州）有限公司	文艺创作;企业管理咨询;办公用品销售;文具用品零售;纸制品销售;玩具销售;品牌管理;咨询策划服务;企业形象策划;市场营销策划;会议及展览服务;信息技术咨询服务;办公设备耗材销售;体育用品及器材零售;企业信用管理咨询服务;教学用模型及教具销售;绘图、计算及测量仪器销售;玩具、动漫及游艺用品销售;文具用品批发;纸浆销售;鞋帽零售;鞋帽批发;互联网设备销售;体育用品及器材批发;互联网销售（除销售需要许可的商品）;信息咨询服务（不含许可类信息咨询服务）;广告发布（非广播电台、电视台、报刊出版单位）;技术服务、技术开发、技术咨询、技术交流、技术转让、技术推广;网络文化经营;出版物零售;出版物互联网销售;出版物批发;互联网直播服务（不含新闻信息服务、网络表演、网络视听节目）
广州国商文化传播有限公司	策划创意服务;信息技术咨询服务;数据处理和存储服务;教育咨询服务;企业总部管理;会议及展览服务;市场调研服务;公共关系服务;群众参与的文艺类演出、比赛等公益性文化活动的策划;企业管理咨询服务
川鹰（广东）文化传媒有限公司	电影和影视节目制作;录音制作;电影和影视节目发行;文艺创作服务;舞台表演化妆服务;舞台表演美工服务;艺术表演场馆管理服务;舞台安装、搭建服务;照明灯光设计服务;舞台灯光、音响设备安装服务;艺（美）术创作服务;舞台表演艺术指导服务;舞台表演道具服务;摄影服务;摄影艺术辅导服务;广告业;个人形象设计服务;时装设计服务;多媒体设计服务;展台设计服务;模型设计服务;灯饰设计服务;室内装饰设计服务;模特服务;大型活动组织策划服务（大型活动指晚会、运动会、庆典、艺术和模特大赛、艺术节、电影节及公益演出、展览等，需专项审批的活动应在取得审批后方可经营）;群众参与的文艺类演出、比赛等公益性文化活动的策划;影视经纪代理服务;公司礼仪服务;策划创意服务;企业形象策划服务;服装和鞋帽出租服务;会议及展览服务
广州玉相缘珠宝文化传播有限公司	钟表销售;工艺美术品及收藏品批发（象牙及其制品除外）;工艺美术品及收藏品零售（象牙及其制品除外）;珠宝首饰回收修理服务;会议及展览服务;珠宝首饰制造;文艺创作;金属链条及其他金属制品销售;广告发布（非广播电台、电视台、报刊出版单位）;市场营销策划;信息技术咨询服务;企业管理;企业管理咨询;软件外包服务;网络与信息安全软件开发;软件开发;软件销售;组织文化艺术交流活动;艺术品代理;技术服务、技术开发、技术咨询、技术交流、技术转让、技术推广;网络技术服务;其他文化艺术经纪代理;计算机系统服务;互联网销售（除销售需要许可的商品）;文具用品零售;国内贸易代理;珠宝首饰批发;珠宝首饰零售;金银制品销售;咨询策划服务;;电子出版物复制;出版物互联网销售;出版物零售;网络文化经营;第二类增值电信业务;第一类增值电信业务;检验检测服务;电子出版物制作
广东江山如画文化传媒有限公司	文化艺术咨询服务;企业形象策划服务;策划创意服务;市场营销策划服务;文艺创作服务;市场调研服务;广告业;电脑打字、录入、校对、打印服务;电脑喷绘、晒图服务;软件开发;货物进出口（专营专控商品除外）;商品批发贸易（许可审批类商品除外）;商品零售贸易（许可审批类商品除外）;贸易咨询服务;技术进出口;生物技术推广服务;软件技术推广服务;会议及展览服务;体育用品及器材批发;体育用品及器材零售;体育运动咨询服务;房屋租赁;物业管理;投资咨询服务;商务咨询服务;卫生洁具零售;家用电器批发;陶瓷、玻璃器皿零售;陶瓷、玻璃器皿批发;五金产品批发;五金零售;家具批发;家具零售;房地产中介服务;文化传播（不含许可经营项目）;营养健康咨询服务;健康科学项目研究、开发;健康科学项目研究成果转让;养老产业投资、开发;养老机构业务（为老年人提供集中居住和照料护理等服务）;养老机构业务，为老年人提供社区托养、居家照护等社区居家养老服务电子出版物出版
广州星聚传媒有限公司	营业性文艺表演;音像制品制作;演出经纪代理服务;录音制作;文艺创作服务;艺（美）术创作服务;舞台表演艺术指导服务;群众参与的文艺类演出、比赛等公益性文化活动的策划;舞台表演安全保护服务;舞台灯光、音响设备安装服务;照明灯光设计服务;文化娱乐经纪人;体育经纪人;影视经纪代理服务;音像经纪代理服务;文学、艺（美）术经纪代理服务;动漫（动画）经纪代理服务;企业形象策划服务;文化艺术咨询服务;策划创意服务;投资咨询服务;广告业;会议及展览服务;包装服务;公司礼仪服务;模特服务;个人形象设计服务;大型活动组织策划服务（大型活动指晚会、运动会、庆典、艺术和模特大赛、艺术节、电影节及公益演出、展览等,需专项审批的活动应在取得审批后方可经营）;商品批发贸易（许可审批类商品除外）;互联网商品销售（许可审批类商品除外）;软件开发;数据处理和存储服务;数字动漫制作;包装装潢设计服务;多媒体设计服务;展台设计服务;美术图案设计服务;网络技术的研究、开发;计算机技术开发、技术服务
广州正恒互动娱乐有限公司	企业形象策划服务;商务咨询服务;公司礼仪服务;策划创意服务;大型活动组织策划服务（大型活动指晚会、运动会、庆典、艺术和模特大赛、艺术节、电影节及公益演出、展览等，需专项审批的活动应在取得审批后方可经营）;群众参与的文艺类演出、比赛等公益性文化活动的策划;市场营销策划服务;广告业;文化娱乐经纪人;美术展览经纪代理服务;文学、艺（美）术经纪代理服务
广州飞猪文化传媒有限公司	电影和影视节目制作;录音制作;广播节目制作;个人形象设计服务;美术展览经纪代理服务;塑料加工专用设备制造;影视经纪代理服务;电影设备及其配件批发;数字动漫制作;动漫（动画）经纪代理服务;舞台表演道具服务;电视设备及其配件批发;广告业;天然研磨料制造;多媒体设计服务;广播设备及其配件批发;影视录放设备制造;模特服务;公司礼仪服务;商品批发贸易（许可审批类商品除外）;商品零售贸易（许可审批类商品除外）
八绎文化（广东）有限公司	广告制作;项目策划与公关服务;会议及展览服务;体育赛事策划;企业形象策划;市场营销策划;信息咨询服务（不含许可类信息咨询服务）;市场调查（不含涉外调查）;公共事业管理服务;企业管理;箱包销售;珠宝首饰零售;文具用品零售;厨具卫具及日用杂品零售;化妆品零售;鞋帽零售;服装服饰零售;游艺及娱乐用品销售;乐器批发;珠宝首饰批发;体育用品及器材批发;文具用品批发;家用电器销售;日用百货销售;厨具卫具及日用杂品批发;鞋帽批发;服装服饰批发;针纺织品及原料销售;食品经营（仅销售预包装食品）;公园、景区小型设施娱乐活动;组织文化艺术交流活动;文化娱乐经纪人服务;个人互联网直播服务（需备案）;文艺创作
广州晶火文化发展有限公司	动漫及衍生产品设计服务;软件开发;数据处理和存储服务;广告业;工程和技术研究和试验发展;商品批发贸易（许可审批类商品除外）;公共关系服务;策划创意服务;公司礼仪服务;模特服务;个人形象设计服务;音像经纪代理服务;影视经纪代理服务;互联网商品销售（许可审批类商品除外）;互联网商品零售（许可审批类商品除外）;艺术表演场馆管理服务;信息系统集成服务;企业管理服务（涉及许可经营项目的除外）;商品零售贸易（许可审批类商品除外）;文化艺术咨询服务;群众参与的文艺类演出、比赛等公益性文化活动的策划;大型活动组织策划服务（大型活动指晚会、运动会、庆典、艺术和模特大赛、艺术节、电影节及公益演出、展览等，需专项审批的活动应在取得审批后方可经营）;摄影服务;信息电子技术服务;工程和技术基础科学研究服务;电子、通信与自动控制技术研究、开发;网络技术的研究、开发;计算机技术开发、技术服务;市场营销策划服务;文艺创作服务;文化娱乐经纪人;展台设计服务;其他文化娱乐用品批发;通信技术研究开发、技术服务;科技项目代理服务;信息技术咨询服务;舞台表演艺术指导服务;时装设计服务;科技信息咨询服务;企业管理咨询服务;企业形象策划服务;多媒体设计服务;电子工程设计服务;演出经纪代理服务;电影和影视节目发行;营业性文艺表演;电影和影视节目制作
广州市大象无形文化旅游发展有限公司	个人形象设计服务;室内装饰、装修;城市及道路照明工程施工;园林绿化工程服务;景观和绿地设施工程施工;室外娱乐用设施工程施工;路牌、路标、广告牌安装施工;旅游景区规划设计、开发、管理;建筑物空调设备、通风设备系统安装服务;水处理安装服务;商业特许经营;环境污染处理专用药剂材料制造（监控化学品、危险化学品除外）;钢材零售;钢材批发;玻璃钢材料批发;玻璃钢材料零售;建材、装饰材料批发;防水材料、防水涂料销售（成品油、监控化学品、危险化学品、易制毒化学品除外）;包装材料的销售;木质装饰材料零售;陶瓷装饰材料零售;金属装饰材料零售;开关、插座、接线板、电线电缆、绝缘材料零售;材料科学研究、技术开发;建筑材料检验服务;建筑材料设计、咨询服务;新材料技术推广服务;新材料技术开发服务;新材料技术咨询、交流服务;新材料技术转让服务;装饰用塑料、化纤、石膏、布料零售;装饰石材零售;土石方工程服务;商品批发贸易（许可审批类商品除外）;商品零售贸易（许可审批类商品除外）;道路护栏安装;电力输送设施安装工程服务;通信设施安装工程服务;输水管道设施安装服务;照明系统安装;建筑物电力系统安装;通信线路和设备的安装;雷达、导航与测控系统工程安装服务;监控系统工程安装服务;电子自动化工程安装服务;电子设备工程安装服务;智能化安装工程服务;建筑物自来水系统安装服务;建筑物排水系统安装服务;建筑物燃气系统安装服务;建筑物采暖系统安装服务;直饮水系统的安装及售后服务;机电设备安装服务;起重设备安装服务;电梯安装工程服务;电梯、自动扶梯及升降机安装;自动人行道安装;建筑钢结构、预制构件工程安装服务;绝缘装置安装服务;人防工程防护设备的安装;专用设备安装（电梯、锅炉除外）;充水橡胶坝、充气橡胶坝、气动盾形闸门的安装;节水灌溉设施工程建造及安装;门窗安装;机电设备安装工程专业承包;标识、标志牌设计、安装服务;充电桩设施安装、管理;家具安装;舞台灯光、音响设备安装服务;舞台安装、搭建服务;舞台机械设计安装服务;体育器材装备安装服务;可移动看台安装服务;多媒体设计服务;动漫及衍生产品设计服务;饰物装饰设计服务;美术图案设计服务;电子产品设计服务;玩具设计服务;模型设计服务
广州中凯文化传媒有限公司	电影摄制服务;市场营销策划;咨询策划服务;项目策划与公关服务;品牌管理;企业形象策划;网络技术服务;广告设计、代理;广告制作;互联网销售（除销售需要许可的商品）;文化娱乐经纪人服务;电视剧制作;电视剧发行;电影发行;广播电视节目制作经营;食品互联网销售（销售预包装食品）;广播电视视频点播业务
星道园影业（广州）有限公司	电影和影视节目制作;广播电视节目制作（具体经营范围以《广播电视节目制作经营许可证》为准）;电影和影视节目发行;大型活动组织策划服务（大型活动指晚会、运动会、庆典、艺术和模特大赛、艺术节、电影节及公益演出、展览等，需专项审批的活动应在取得审批后方可经营）;企业形象策划服务;市场营销策划服务;摄影服务;计算机技术开发、技术服务;影视经纪代理服务;公司礼仪服务
广州番禺莲花山高尔夫球度假俱乐部有限公司	运动场馆服务（游泳馆除外）;体育用品及器材零售;场地租赁（不含仓储）;中餐服务;甜品制售
广州弈希健身俱乐部有限公司	体育组织;美容健身咨询服务;企业管理服务（涉及许可经营项目的除外）;货物进出口（专营专控商品除外）;商品批发贸易（许可审批类商品除外）;体育赛事运营（涉及许可项目的,需取得许可后方可经营）;互联网商品销售（许可审批类商品除外）;商品零售贸易（许可审批类商品除外）;竞技体育科技服务;全民健身科技服务;体育工程科技服务;体育器材装备安装服务;体育用品及器材批发;体育用品及器材零售;体育设备、器材出租;运动场馆服务（游泳馆除外）;互联网商品零售（许可审批类商品除外）;技术进出口;体育营销策划服务;体育项目投资与管理;健身服务;服装批发;服装零售;水果批发;水果零售;茶叶作物及饮料作物批发;出境旅游招徕、咨询服务;向游客提供旅游、交通、住宿、餐饮等代理服务（不涉及旅行社业务）;房屋租赁;场地租赁（不含仓储）;游泳馆;预包装食品零售;保健食品零售（具体经营项目以《食品经营许可证》为准）;非酒精饮料、茶叶批发;非酒精饮料及茶叶零售;出境旅游业务;境内旅游业务
京元素（广州）影视文化有限公司	文学、艺（美）术经纪代理服务;无形资产评估服务;科技项目评估服务;广告业;网络信息技术推广服务;文化推广（不含许可经营项目）;工艺美术品零售（象牙及其制品除外）;珠宝鉴定服务;收藏品零售（国家专营专控的除外）;艺（美）术品、收藏品鉴定、咨询服务;电影和影视节目制作;电影和影视节目发行;展览馆
广州华矩传媒有限公司	娱乐性展览;广告设计、代理;企业管理咨询;企业管理;文化娱乐经纪人服务;咨询策划服务;信息咨询服务（不含许可类信息咨询服务）;组织文化艺术交流活动;信息技术咨询服务;互联网数据服务;其他文化艺术经纪代理;数字内容制作服务（不含出版发行）;网络技术服务;文化场馆管理服务;文艺创作;电影摄制服务;营业性演出;演出经纪;信息网络传播视听节目;互联网直播服务（不含新闻信息服务、网络表演、网络视听节目）;网络文化经营;互联网信息服务;广播电视节目制作经营;音像制品制作
广州寰影时代电视传媒有限公司	文艺创作;个人互联网直播服务（需备案）;文化场馆管理服务;游乐园服务;组织体育表演活动;文化娱乐经纪人服务;体育经纪人服务;其他文化艺术经纪代理;组织文化艺术交流活动;公园、景区小型设施娱乐活动;娱乐性展览;电影摄制服务;信息系统集成服务;信息技术咨询服务;企业形象策划;电视剧制作;广播电视节目制作经营;营业性演出;演出经纪
广州小马过河儿童娱乐有限公司	室内非射击类、非球类、非棋牌类的竞技娱乐活动（不含电子游艺、攀岩、蹦床）;室内手工制作娱乐服务;经营迷你歌咏亭;经营投币夹公仔机（法律法规禁止的项目不得经营,法律法规限制的项目取得许可后方可经营）;企业形象策划服务;策划创意服务;市场营销策划服务;体育营销策划服务;大型活动组织策划服务（大型活动指晚会、运动会、庆典、艺术和模特大赛、艺术节、电影节及公益演出、展览等,需专项审批的活动应在取得审批后方可经营）;群众参与的文艺类演出、比赛等公益性文化活动的策划;商品批发贸易（许可审批类商品除外）;商品零售贸易（许可审批类商品除外）;互联网商品零售（许可审批类商品除外）;玩具批发;玩具零售;玩具设计服务;体育用品及器材批发;体育用品及器材零售;体育设备、器材出租;体育运动咨询服务;体育项目投资与管理;体育赛事运营（涉及许可项目的,需取得许可后方可经营）;体育器材的技术研究、开发;体育、休闲娱乐工程设计服务;体育组织;竞技体育科技服务;体育工程科技服务;体育器材装备安装服务;卡丁车
九州文化产业发展（广东）有限公司	文化传播（不含许可经营项目）;文化推广（不含许可经营项目）;艺（美）术品、收藏品鉴定、咨询服务;群众参与的文艺类演出、比赛等公益性文化活动的策划;艺（美）术装裱、封装服务;艺（美）术创作服务;书法篆刻创作服务;绘画艺术创作服务;雕刻艺术创作服务;文艺创作服务;信息技术咨询服务;软件开发;数据处理和存储服务;信息系统集成服务;互联网商品销售（许可审批类商品除外）;互联网商品零售（许可审批类商品除外）;电子产品批发;电子产品零售;会议及展览服务;电子商务信息咨询;企业形象策划服务;商品信息咨询服务;旅客票务代理;向游客提供旅游、交通、住宿、餐饮等代理服务（不涉及旅行社业务）;广告业;商品批发贸易（许可审批类商品除外）;策划创意服务;商品零售贸易（许可审批类商品除外）;市场营销策划服务;软件技术推广服务;计算机批发;计算机零配件批发;计算机技术开发、技术服务;计算机硬件的研究、开发;计算机信息安全产品设计;电子、通信与自动控制技术研究、开发;通信技术研究开发、技术服务;通信信号工程设计服务;通信工程设计服务;通信系统设备产品设计;通信信号技术咨询服务;电子产品设计服务;文化艺术咨询服务;文化研究;大型活动组织策划服务（大型活动指晚会、运动会、庆典、艺术和模特大赛、艺术节、电影节及公益演出、展览等，需专项审批的活动应在取得审批后方可经营）;美术展览经纪代理服务
广东四季高尔夫球俱乐部股份有限公司	花卉作物批发;谷物副产品批发;蔬菜收购;水果批发;干果、坚果批发;蔬菜批发;食用菌批发;冷冻肉批发;海味干货批发;海味干货零售;蛋类批发;水产品批发;鲜肉批发（仅限猪、牛、羊肉）;油料作物批发;餐饮管理;酒店管理;体育项目投资与管理;技术进出口;充值卡销售;体育组织;商品信息咨询服务;货物进出口（专营专控商品除外）;体育用品及器材零售;体育用品及器材批发;健身服务;体育运动咨询服务;商品批发贸易（许可审批类商品除外）;互联网商品销售（许可审批类商品除外）;互联网商品零售（许可审批类商品除外）;投资咨询服务;谷物、豆及薯类批发;茶叶作物及饮料作物批发;广告业;乳制品批发;散装食品批发;散装食品零售;酒类批发;专业网络平台的构建和运营（法律、行政法规、国务院决定禁止的项目除外,依法须取得许可的项目,须取得许可后方可经营）;增值电信服务（业务种类以《增值电信业务经营许可证》载明内容为准）;预包装食品批发;米、面制品及食用油批发;糕点、糖果及糖批发;肉制品批发（鲜肉、冷却肉除外）;非酒精饮料、茶叶批发
广东汇纵文化传播有限公司	文化推广（不含许可经营项目）;文化传播（不含许可经营项目）;艺（美）术品、收藏品鉴定、咨询服务;项目投资（不含许可经营项目，法律法规禁止经营的项目不得经营）;工艺品批发（象牙及其制品除外）;广告业;文化艺术咨询服务;互联网商品销售（许可审批类商品除外）;互联网商品零售（许可审批类商品除外）;企业自有资金投资;收藏品零售（国家专营专控的除外）;收藏品批发（国家专营专控的除外）;电子商务信息咨询;市场营销策划服务;策划创意服务;企业形象策划服务;贸易代理;商品批发贸易（许可审批类商品除外）;商品零售贸易（许可审批类商品除外）;贸易咨询服务;佣金代理;专业网络平台的构建和运营（法律、行政法规、国务院决定禁止的项目除外，依法须取得许可的项目，须取得许可后方可经营）;文物拍卖;拍卖
广州风楼文化传播有限公司	文化传播（不含许可经营项目）;艺（美）术装裱、封装服务;艺术表演场馆管理服务;舞台表演艺术指导服务;舞台安装、搭建服务;照明灯光设计服务;舞台表演美工服务;舞台表演道具服务;舞台表演化妆服务;舞台表演安全保护服务;群众参与的文艺类演出、比赛等公益性文化活动的策划;互联网商品销售（许可审批类商品除外）;互联网商品零售（许可审批类商品除外）;信息技术咨询服务;数字动漫制作;商品批发贸易（许可审批类商品除外）;舞台机械设计安装服务;舞台灯光、音响设备安装服务;艺（美）术创作服务
广东俞氏伟业影视制作有限公司	电影和影视节目制作;电影和影视节目发行;演出经纪代理服务;大型活动组织策划服务（大型活动指晚会、运动会、庆典、艺术和模特大赛、艺术节、电影节及公益演出、展览等，需专项审批的活动应在取得审批后方可经营）;舞台表演艺术指导服务;个人形象设计服务;广告业;商品零售贸易（许可审批类商品除外）;餐饮管理;软件批发;软件零售;软件开发;软件服务;计算机批发;计算机技术开发、技术服务
中科蓝湾贸易发展（广州）有限公司	美发饰品销售;电热食品加工设备销售;成人情趣用品销售（不含药品、医疗器械）;木材销售;茶具销售;鲜蛋批发;办公用品销售;日用木制品销售;日用杂品销售;生活垃圾处理装备销售;玩具销售;洗涤机械销售;药物检测仪器销售;营林及木竹采伐机械销售;云计算设备销售;照明器具生产专用设备销售;纸浆销售;制浆和造纸专用设备销售;教学用模型及教具销售;计算器设备销售;集成电路芯片及产品销售;减振降噪设备销售;半导体器件专用设备销售;齿轮及齿轮减、变速箱销售;畜牧机械销售;弹簧销售;导航终端销售;地板销售;地质勘查专用设备销售;地质勘探和地震专用仪器销售;电池销售;电工器材销售;电工仪器仪表销售;电力测功电机销售;电力电子元器件销售;电气机械设备销售;电子元器件与机电组件设备销售;电子专用设备销售;纺织专用测试仪器销售;纺织专用设备销售;非电力家用器具销售;风动和电动工具销售;服务消费机器人销售;高铁设备、配件销售;供应用仪器仪表销售;光电子器件销售;光缆销售;光通信设备销售;光纤销售;光学玻璃销售;光学仪器销售;广播电视传输设备销售;海水养殖和海洋生物资源利用装备销售;海洋工程装备销售;海洋能发电机组销售;海洋能系统与设备销售;环境监测专用仪器仪表销售;绘图、计算及测量仪器销售;合成纤维销售;衡器销售;烘炉、熔炉及电炉销售;幻灯及投影设备销售;货币专用设备销售;机床功能部件及附件销售;建筑工程用机械销售;教学专用仪器销售;金属丝绳及其制品销售;轮胎销售;木竹材加工机械销售;农、林、牧、副、渔业专业机械的销售;农副食品加工专用设备销售;农业机械销售;燃煤烟气脱硫脱硝装备销售;染料销售;宠物销售;中草药收购;饲料添加剂销售;互联网销售（除销售需要许可的商品）;建筑装饰材料销售;卫生洁具销售;户外用品销售;礼品花卉销售;日用品销售;特种劳动防护用品销售;卫生用品和一次性使用医疗用品销售;日用口罩（非医用）销售;特殊医学用途配方食品销售;办公设备销售;橡胶制品销售;煤炭及制品销售;第二类医疗器械销售;游艺及娱乐用品销售;家用电器销售;农副产品销售;林业产品销售;棉、麻销售;豆及薯类销售;谷物销售;电器辅件销售;电子产品销售;服装辅料销售;轻质建筑材料销售;环境保护专用设备销售;专用化学产品销售（不含危险化学品）;农作物种子经营（仅限不再分装的包装种子）;水产品零售;家具销售;日用家电零售;新鲜蔬菜零售;厨具卫具及日用杂品零售;汽车零配件零售;体育用品及器材零售;医用口罩零售;集中式快速充电站;新鲜水果零售;制药专用设备制造;地产中草药（不含中药饮片）购销;药物临床试验服务;药品生产;药品批发;药品零售;药品互联网信息服务;中药饮片代煎服务;药品进出口
广州欢聚影业有限公司	电影和影视节目制作;付费广播节目播出服务;图书批发;信息网络传播视听节目业务;录音制作;网络音乐服务;演出经纪代理服务;国内广播节目播出服务;图书、报刊零售;国外广播节目播出服务;电影和影视节目发行;广播电视节目制作（具体经营范围以《广播电视节目制作经营许可证》为准）;图书出版;数字动漫制作;音像经纪代理服务;文化娱乐经纪人;票务服务;影视经纪代理服务
广州市番禺区瑞森体育有限公司	室内体育场、娱乐设施工程服务;室外体育设施工程施工;体育赛事运营（涉及许可项目的，需取得许可后方可经营）;体育运动咨询服务;体育营销策划服务;房屋租赁;物业管理;园林绿化工程服务;体育组织;运动场馆服务（游泳馆除外）;商品批发贸易（许可审批类商品除外）;商品零售贸易（许可审批类商品除外）;广告业
广州市荷里活影视有限公司	电影和影视节目制作;电影和影视节目发行;艺术表演场馆管理服务;艺（美）术创作服务;文化娱乐经纪人;企业形象策划服务;策划创意服务;广告业;数字动漫制作;个人形象设计服务;室外娱乐用设施工程施工;市场营销策划服务;影视经纪代理服务;影视录放设备制造;大型活动组织策划服务（大型活动指晚会、运动会、庆典、艺术和模特大赛、艺术节、电影节及公益演出、展览等,需专项审批的活动应在取得审批后方可经营）;公司礼仪服务;模特服务;舞台表演艺术指导服务;舞台表演安全保护服务;舞台表演化妆服务;舞台灯光、音响设备安装服务;绘画艺术创作服务;美术展览经纪代理服务;动漫（动画）经纪代理服务;音像经纪代理服务
广东蔚兰星文化传媒有限公司	电影摄制服务;广播影视设备销售;影视美术道具置景服务;文化娱乐经纪人服务;其他文化艺术经纪代理;文化场馆管理服务;组织文化艺术交流活动;摄像及视频制作服务;广播电视节目制作经营;电影发行;电影放映;电视剧制作;电视剧发行;音像制品制作;信息网络传播视听节目;互联网直播服务（不含新闻信息服务、网络表演、网络视听节目）;演出经纪;营业性演出;演出场所经营;互联网信息服务
广州中骐江畔体育文化有限公司	体育中介代理服务;体育健康服务;体育竞赛组织;台球活动;休闲观光活动;组织体育表演活动;文化娱乐经纪人服务;体育经纪人服务;其他文化艺术经纪代理;组织文化艺术交流活动;公园、景区小型设施娱乐活动;城市公园管理;会议及展览服务;娱乐性展览;海滩浴场更衣及租借用品服务;文化场馆管理服务;健身休闲活动;广告设计、代理;广告制作;广告发布（非广播电台、电视台、报刊出版单位）;旅行社服务网点旅游招徕、咨询服务;电子烟雾化器（非烟草制品、不含烟草成分）销售;游乐园服务;租借道具活动;动物园管理服务;游艺及娱乐用品销售;休闲娱乐用品设备出租;森林公园管理;体育保障组织;教育咨询服务（不含涉许可审批的教育培训活动）;票务代理服务;旅客票务代理;票据信息咨询服务;市场营销策划;酒店管理;玩具销售;玩具、动漫及游艺用品销售;服装服饰零售;服装辅料销售;服装服饰出租;鞋帽零售;技术服务、技术开发、技术咨询、技术交流、技术转让、技术推广;品牌管理;物业管理;体验式拓展活动及策划;住房租赁;非居住房地产租赁;土地使用权租赁;房地产评估;房地产咨询;房地产经纪;柜台、摊位出租;家政服务;专业保洁、清洗、消毒服务;专业设计服务;停车场服务;物业服务评估;咨询策划服务;数字内容制作服务（不含出版发行）;数字文化创意内容应用服务;礼仪服务;信息咨询服务（不含许可类信息咨询服务）;商务代理代办服务;企业管理咨询;企业管理;企业形象策划;以自有资金从事投资活动;园区管理服务;项目策划与公关服务;规划设计管理;对外承包工程;金属门窗工程施工;家具销售;家具安装和维修服务;装卸搬运;工程管理服务;住宅水电安装维护服务;门窗制造加工;园林绿化工程施工;体育场地设施工程施工;建筑材料销售;劳务服务（不含劳务派遣）;家居用品销售;家用电器销售;对外承包工程;针纺织品及原料销售;针纺织品销售;日用品销售;日用品批发;电子产品销售;礼品花卉销售;珠宝首饰零售;珠宝首饰批发;个人卫生用品销售;卫生用品和一次性使用医疗用品销售;日用百货销售;厨具卫具及日用杂品零售;塑料制品销售;文具用品零售;文具用品批发;游艺用品及室内游艺器材销售;服装服饰批发;鞋帽批发;普通货物仓储服务（不含危险化学品等需许可审批的项目）;艺术考级活动;演出场所经营;健身气功站点经营;演出经纪;食品经营（销售预包装食品）;营业性演出;体育场地设施经营（不含高危险性体育运动）;高危险性体育运动（游泳）;高危险性体育运动（滑雪）;高危险性体育运动（潜水）;高危险性体育运动（攀岩）;射击竞技体育运动;歌舞娱乐活动;游艺娱乐活动;酒吧服务（不含演艺娱乐活动）;互联网上网服务;餐饮服务;小餐饮、小食杂、食品小作坊经营;小餐饮;食品小作坊经营;食品经营;食品经营（销售散装食品）;住宿服务;动物饲养;互联网直播服务（不含新闻信息服务、网络表演、网络视听节目）;食品互联网销售（销售预包装食品）;广告发布（广播电台、电视台、报刊出版单位）;旅游业务;酒类经营;房地产开发经营;现制现售饮用水;烟草制品零售;国内船舶管理业务;船舶检验服务;省际普通货船运输、省内船舶运输;船舶引航服务;动物诊疗;住宅室内装饰装修;各类工程建设活动;施工专业作业;房屋建筑和市政基础设施项目工程总承包;盲人医疗按摩服务;足浴服务;道路货物运输（含危险货物）
广州市大海豚文化发展有限公司	文艺创作服务;雕刻艺术创作服务;绘画艺术创作服务;书法篆刻创作服务;艺（美）术创作服务;艺（美）术装裱、封装服务;艺术表演场馆管理服务;舞台表演艺术指导服务;舞台表演安全保护服务;舞台表演美工服务;舞台表演道具服务;舞台表演化妆服务;舞台灯光、音响设备安装服务;舞台安装、搭建服务;照明灯光设计服务;电子产品批发;电子元器件批发;电子元器件零售;电子产品零售
广州穹顶之下文化传播有限公司	文艺创作服务;艺术表演场馆管理服务;文化艺术咨询服务;策划创意服务;市场营销策划服务;企业形象策划服务;群众参与的文艺类演出、比赛等公益性文化活动的策划;大型活动组织策划服务（大型活动指晚会、运动会、庆典、艺术和模特大赛、艺术节、电影节及公益演出、展览等，需专项审批的活动应在取得审批后方可经营）;会议及展览服务;市场调研服务;摄影服务;公共关系服务;企业管理咨询服务;商品信息咨询服务;投资咨询服务;广告业;公司礼仪服务;舞台表演艺术指导服务;舞台灯光、音响设备安装服务;舞台安装、搭建服务;照明灯光设计服务;影视经纪代理服务;文学、艺（美）术经纪代理服务;商品批发贸易（许可审批类商品除外）;商品零售贸易（许可审批类商品除外）
广州市佳视计算机科技有限公司	人工智能算法软件的技术开发与技术服务;计算机零售;计算机和辅助设备修理;电子设备工程安装服务;计算机技术开发、技术服务;计算机外围设备制造;货物进出口（专营专控商品除外）;技术进出口;软件开发;软件服务;贸易代理;商品批发贸易（许可审批类商品除外）;商品零售贸易（许可审批类商品除外）;集成电路设计;游戏软件设计制作;工业设计服务;多媒体设计服务;模型设计服务;金属结构件设计服务;数字动漫制作;动漫及衍生产品设计服务;露天游乐场所游乐设备制造;智能穿戴设备的销售;家用视听设备零售
广州奥园文化传媒有限公司	文艺创作;文化场馆管理服务;组织文化艺术交流活动;文化用品设备出租;文化娱乐经纪人服务;普通机械设备安装服务;专业设计服务;广告设计、代理;广告制作;广告发布（非广播电台、电视台、报刊出版单位）;市场营销策划;企业形象策划;咨询策划服务;礼仪服务;会议及展览服务;组织体育表演活动;其他文化艺术经纪代理;项目策划与公关服务;体验式拓展活动及策划;租借道具活动;工艺美术品及礼仪用品制造（象牙及其制品除外）;互联网销售（除销售需要许可的商品）;建筑物清洁服务;劳务服务（不含劳务派遣）;房地产咨询;房地产经纪;影视录放设备制造;建筑材料销售;营业性演出;演出场所经营;网络文化经营;住宅室内装饰装修;包装装潢印刷品印刷;货物进出口;广播电视节目制作经营;酒类经营;旅游业务
广州独角兽文化发展有限公司	文艺创作;非物质文化遗产保护;文物文化遗址保护服务;教育咨询服务（不含涉许可审批的教育培训活动）;信息咨询服务（不含许可类信息咨询服务）;信息技术咨询服务;婚姻介绍服务;互联网安全服务;专业设计服务;组织文化艺术交流活动;健康咨询服务（不含诊疗服务）;技术服务、技术开发、技术咨询、技术交流、技术转让、技术推广;从事语言能力、艺术、体育、科技等培训的营利性民办培训服务机构（除面向中小学生开展的学科类、语言类文化教育培训）;第二类增值电信业务
广州玛斯顿影音有限公司	电子产品批发;电子产品零售;货物进出口（专营专控商品除外）;技术进出口;商品零售贸易（许可审批类商品除外）;电子设备工程安装服务;电力电子元器件制造;电子元件及组件制造;商品批发贸易（许可审批类商品除外）;贸易代理;电子元器件零售;电子元器件批发;光电子器件及其他电子器件制造;家用视听设备零售;舞台灯光、音响设备安装服务;音响设备制造;机电设备安装服务;机电设备安装工程专业承包;电气设备修理;电气设备批发;电气机械设备销售;电气设备零售;电气防火技术检测服务;通讯设备及配套设备批发;通讯终端设备批发;计算机及通讯设备租赁;通讯设备修理;电子快译通、电子记事本、电子词典等电子设备制造;电子产品设计服务;数据处理和存储产品设计;计算机信息安全产品设计;通信系统设备产品设计;玩具批发;乐器批发;照相器材批发;日用杂品综合零售;体育用品及器材零售;日用家电设备零售;软件零售;办公设备耗材零售;通信设备零售;安全技术防范产品零售;五金零售;灯具零售;电力输送设施安装工程服务;通信设施安装工程服务;电子自动化工程安装服务;智能化安装工程服务;体育、休闲娱乐工程设计服务;风景园林工程设计服务;建筑工程、土木工程技术服务;建筑工程、土木工程技术开发服务;建筑工程后期装饰、装修和清理;室内装饰、装修;灯具、装饰物品批发;建材、装饰材料批发;装饰用塑料、化纤、石膏、布料零售;装饰石材零售;室内装饰设计服务;饰物装饰设计服务;创业投资;投资咨询服务;体育项目投资与管理;录音制作
广州信源体育产业有限公司	体育器材及配件制造;体育器材装备安装服务;运动场馆服务（游泳馆除外）;体育工程科技服务;全民健身科技服务;竞技体育科技服务;涂料制造（监控化学品、危险化学品除外）;合成橡胶制造（监控化学品、危险化学品除外）;其他合成材料制造（监控化学品、危险化学品除外）;粘合剂制造（监控化学品、危险化学品除外）;室内体育场、娱乐设施工程服务;室外体育设施工程施工;体育、休闲娱乐工程设计服务;体育用品及器材零售;体育用品及器材批发;体育设备、器材出租;其他体育用品制造;文教体育用品专用机械制造;训练健身器材制造;商品批发贸易（许可审批类商品除外）;货物进出口（专营专控商品除外）;体育组织
广州明通文化传媒有限公司	文艺创作;会议及展览服务;广告制作;广告发布（非广播电台、电视台、报刊出版单位）;广告设计、代理;社会调查（不含涉外调查）;品牌管理;市场营销策划;市场调查（不含涉外调查）;专业设计服务;平面设计;图文设计制作;信息咨询服务（不含许可类信息咨询服务）;信息技术咨询服务;咨询策划服务;项目策划与公关服务;企业形象策划;旅游开发项目策划咨询;软件开发;非居住房地产租赁;住房租赁;组织文化艺术交流活动;组织体育表演活动;文化娱乐经纪人服务;体育经纪人服务;其他文化艺术经纪代理;电影摄制服务;摄像及视频制作服务;社会经济咨询服务;体验式拓展活动及策划;礼仪服务;融资咨询服务;企业管理咨询;企业管理;电动汽车充电基础设施运营;航空运营支持服务;体育赛事策划;公共事业管理服务;园区管理服务;互联网销售（除销售需要许可的商品）;食品经营（仅销售预包装食品）;食品互联网销售（销售预包装食品）
广州众一文化传播有限公司	舞台表演化妆服务;舞台表演道具服务;舞台安装、搭建服务;策划创意服务;市场营销策划服务;会议及展览服务;广告业;群众参与的文艺类演出、比赛等公益性文化活动的策划;商品信息咨询服务;大型活动组织策划服务（大型活动指晚会、运动会、庆典、艺术和模特大赛、艺术节、电影节及公益演出、展览等，需专项审批的活动应在取得审批后方可经营）;软件开发;计算机技术开发、技术服务;企业管理咨询服务;企业形象策划服务;摄影服务;个人形象设计服务;多媒体设计服务;展台设计服务;游戏软件设计制作;灯光设备租赁;音频和视频设备租赁;自有设备租赁（不含许可审批项目）;建筑用木料及木材组件加工;金属建筑装饰材料制造;有色金属合金制造;房屋建筑工程设计服务;美术图案设计服务;日用塑料制品制造;木制容器制造;软木制品及其他木制品制造
广州市沃柏居文化发展有限公司	艺术表演场馆管理服务;陶瓷、玻璃器皿零售;货物进出口（专营专控商品除外）;花卉作物批发;家居饰品批发;投资管理服务;饰物装饰设计服务;风景园林工程设计服务;商品批发贸易（许可审批类商品除外）;资产管理（不含许可审批项目）;灯具、装饰物品批发;绿化管理、养护、病虫防治服务;园林绿化工程服务;室内装饰设计服务;商品零售贸易（许可审批类商品除外）;投资咨询服务;花盆栽培植物零售
怀圣塔光国术（广州）文化发展有限公司	区块链技术相关软件和服务;服装服饰批发;服装服饰零售;珠宝首饰零售;水产品零售;水产品批发;汽车零配件零售;食品销售（仅销售预包装食品）;食品互联网销售（仅销售预包装食品）;保健食品（预包装）销售;鲜蛋零售;鲜蛋批发;食用农产品批发;食用农产品零售;谷物销售;豆及薯类销售;畜牧渔业饲料销售;饲料原料销售;饲料添加剂销售;日用化学产品销售;食品添加剂销售;家用电器销售;日用家电零售;工业设计服务;健身休闲活动;体育用品设备出租;体育用品及器材零售;体育用品及器材批发;体育经纪人服务;体育中介代理服务;体育健康服务;体育竞赛组织;厨具卫具及日用杂品零售;艺术品代理;工艺美术品及收藏品批发（象牙及其制品除外）;工艺美术品及收藏品零售（象牙及其制品除外）;日用杂品销售;非食用农产品初加工;食用农产品初加工;农副产品销售;娱乐性展览;艺（美）术品、收藏品鉴定评估服务;电影摄制服务;文化场馆管理服务;游览景区管理;城市公园管理;名胜风景区管理;规划设计管理;信息系统集成服务;新材料技术推广服务;新材料技术研发;网络与信息安全软件开发;摄像及视频制作服务;摄影扩印服务;文化用品设备出租;计算机及通讯设备租赁;建筑工程机械与设备租赁;非居住房地产租赁;住房租赁;影视美术道具置景服务;工程管理服务;房地产咨询;组织体育表演活动;文化娱乐经纪人服务;家具销售;平面设计;信息技术咨询服务;网络技术服务;软件开发;动漫游戏开发;数字内容制作服务（不含出版发行）;咨询策划服务;其他文化艺术经纪代理;文艺创作;组织文化艺术交流活动;普通机械设备安装服务;技术服务、技术开发、技术咨询、技术交流、技术转让、技术推广;专业设计服务;中医养生保健服务（非医疗）;养生保健服务（非医疗）;互联网销售（除销售需要许可的商品）;健康咨询服务（不含诊疗服务）;会议及展览服务;法律咨询（不包括律师事务所业务）;广告制作;信息咨询服务（不含许可类信息咨询服务）;市场调查（不含涉外调查）;广告设计、代理;项目策划与公关服务;体育赛事策划;礼仪服务;市场营销策划;企业管理咨询;人力资源服务（不含职业中介活动、劳务派遣服务）;园区管理服务;商务代理代办服务;广告发布（非广播电台、电视台、报刊出版单位）;国内贸易代理;电子产品销售;水产苗种进出口;进出口代理;技术进出口;货物进出口;保税仓库经营;食品销售;食品经营（销售散装食品）;食品互联网销售;食用菌菌种经营;医疗器械互联网信息服务;药品互联网信息服务;出版物批发;广播电视节目制作经营;演出经纪;音像制品复制;音像制品制作;信息网络传播视听节目;互联网信息服务;电子认证服务;出版物互联网销售;出版物零售;营业性演出;住宅室内装饰装修;建设工程设计;体育场地设施经营（不含高危险性体育运动）
广东洋阳传媒有限公司	国内版出版物的批发、零售、连锁经营（按有效许可证经营）；销售：计算机，百货，工艺美术品，花草；商贸信息咨询；市场营销开发、经营的咨询。
嘉桐娜（广州）文化传播有限公司	文艺创作;其他文化艺术经纪代理;组织文化艺术交流活动;体育健康服务;体育中介代理服务;健身休闲活动;组织体育表演活动;摄影扩印服务;互联网销售（除销售需要许可的商品）;服装服饰批发;服装服饰零售;服装辅料销售;服装、服饰检验、整理服务;鞋帽批发;教育咨询服务（不含涉许可审批的教育培训活动）;广告设计、代理
广东生命之源健身运动有限公司	体育工程科技服务;食品科学技术研究服务;商品信息咨询服务;健美运动技术咨询;美容健身咨询服务;企业管理咨询服务;预包装食品批发;食品检测服务;食品经营管理;散装食品批发
广州市英明文化传播有限公司	演出经纪代理服务;广播电视节目制作（具体经营范围以《广播电视节目制作经营许可证》为准）;电影和影视节目制作;电影和影视节目发行;录音制作;文化娱乐经纪人;影视经纪代理服务
广州众视网络传媒有限公司	会议及展览服务;公司礼仪服务;舞台表演美工服务;舞台表演道具服务;照明灯光设计服务;文化娱乐经纪人;体育经纪人;影视经纪代理服务;音像经纪代理服务;文学、艺（美）术经纪代理服务;美术展览经纪代理服务;动漫（动画）经纪代理服务;文化推广（不含许可经营项目）;文化传播（不含许可经营项目）;群众参与的文艺类演出、比赛等公益性文化活动的策划;企业总部管理;酒店管理;餐饮管理;企业管理服务（涉及许可经营项目的除外）;企业管理咨询服务;企业形象策划服务;文化艺术咨询服务;体育运动咨询服务;市场调研服务;市场营销策划服务;广告业;软件服务;模特服务;个人形象设计服务;大型活动组织策划服务（大型活动指晚会、运动会、庆典、艺术和模特大赛、艺术节、电影节及公益演出、展览等，需专项审批的活动应在取得审批后方可经营）;票务服务;艺术表演场馆管理服务;舞台表演艺术指导服务;人力资源供求信息的收集和发布;人力资源管理咨询;人力资源服务外包;人力资源测评;就业和创业指导;人力资源培训;人力资源外包;劳务承揽;接受委托从事劳务外包服务;百货零售（食品零售除外）;纺织品及针织品零售;服装零售;化妆品及卫生用品零售;眼镜零售;箱、包零售;自行车零售;钟表零售;体育用品及器材零售;钻石首饰零售;家用视听设备零售;日用家电设备零售;商务咨询服务;策划创意服务;办公服务;为中小企业提供信用担保;体育赛事运营（涉及许可项目的，需取得许可后方可经营）;人才推荐;人才测评;人才培训;人才择业咨询指导;人事代理;人才信息网络服务;人才引进;大学生就业推荐;职业信息服务;收集、整理、储存和发布人才、职业供求信息;职业介绍;职业指导;组织开展现场招聘会;根据国家有关规定从事互联网人力资源信息服务;为用人单位推荐劳动者;开展网络招聘;为用人单位和个人提供职业介绍信息服务;开展高级人才寻访服务;为劳动者介绍用人单位;向境外派遣各类劳务人员（不含海员）;对外劳务合作;境外就业中介服务;图书、报刊零售;音像制品及电子出版物零售
禾晟建设控股（广州）有限公司	人力资源服务（不含职业中介活动、劳务派遣服务）;互联网销售（除销售需要许可的商品）;广告发布（非广播电台、电视台、报刊出版单位）;企业管理咨询;企业管理;环保咨询服务;健康咨询服务（不含诊疗服务）;信息咨询服务（不含许可类信息咨询服务）;信息技术咨询服务;建筑材料销售;水利相关咨询服务;工程技术服务（规划管理、勘察、设计、监理除外）;工程管理服务;;建筑劳务分包;房屋建筑和市政基础设施项目工程总承包;建设工程设计
广州彩蛋文化传媒有限公司	广告发布（非广播电台、电视台、报刊出版单位）;服装服饰批发;服装服饰零售;信息咨询服务（不含许可类信息咨询服务）;美发饰品销售;互联网销售（除销售需要许可的商品）;市场营销策划;技术服务、技术开发、技术咨询、技术交流、技术转让、技术推广;文化娱乐经纪人服务;软件开发;广告设计、代理;箱包销售;信息技术咨询服务;品牌管理;区块链技术相关软件和服务;组织文化艺术交流活动;业务培训（不含教育培训、职业技能培训等需取得许可的培训）;安全咨询服务;互联网销售（除销售需要许可的商品）;互联网信息服务;网络文化经营;食品互联网销售（销售预包装食品）
广州蜜淘文化传播有限公司	雨水、微咸水及矿井水的收集处理及利用;海水淡化处理;污水处理及其再生利用;热力生产和供应;娱乐性展览;公园、景区小型设施娱乐活动;组织文化艺术交流活动;其他文化艺术经纪代理;文化娱乐经纪人服务;文化用品设备出租;办公设备租赁服务;租赁服务（不含许可类租赁服务）;广告制作;办公服务;广告设计、代理;文化场馆管理服务;文艺创作;自来水生产与供应;水力发电;发电、输电、供电业务;发电业务、输电业务、供（配）电业务;演出经纪;电影发行;音像制品制作;电视剧发行;电视剧制作;广播电视节目制作经营;广告发布（广播电台、电视台、报刊出版单位）;演出场所经营
广州市番禺美丽华大酒店有限公司	保龄球服务;健身服务;台球服务;洗衣服务;棋牌服务;酒店住宿服务（旅业）;中餐服务;保健按摩;歌舞厅娱乐活动;洗浴服务;小型综合商店、小卖部;酒吧服务
广州钰杰文艺创作有限公司	文艺创作服务;教育咨询服务;国学教育咨询服务;体育设备、器材出租;语言培训;体育培训;美术辅导服务;舞蹈辅导服务;音乐辅导服务;瑜伽辅导服务;武术辅导服务;戏剧艺术辅导服务;工艺美术辅导服务;表演艺术辅导服务;摄影艺术辅导服务;艺术表演场馆管理服务;舞台表演艺术指导服务;舞台表演化妆服务;群众参与的文艺类演出、比赛等公益性文化活动的策划;珠宝鉴定服务;体育组织;灯光设备租赁;音频和视频设备租赁;大型活动组织策划服务（大型活动指晚会、运动会、庆典、艺术和模特大赛、艺术节、电影节及公益演出、展览等,需专项审批的活动应在取得审批后方可经营）;场地租赁（不含仓储）;文化娱乐经纪人;模特服务;商品批发贸易（许可审批类商品除外）;商品零售贸易（许可审批类商品除外）;艺（美）术创作服务;企业管理咨询服务;公司礼仪服务;投资咨询服务;体育工程科技服务;体育经纪人;文学、艺（美）术经纪代理服务
广州维尔吉姆健身服务有限公司	全民健身科技服务;体育组织;体育器材装备安装服务;体育工程科技服务;健身服务;竞技体育科技服务;美容健身咨询服务;运动场馆服务（游泳馆除外）;场地租赁（不含仓储）;游泳馆;美容服务
广州卓诚文化发展有限公司	咨询策划服务;会议及展览服务;组织体育表演活动;组织文化艺术交流活动;体验式拓展活动及策划;公园、景区小型设施娱乐活动;凭总公司授权开展经营活动;项目策划与公关服务;租借道具活动;体育赛事策划;体育竞赛组织;休闲观光活动;娱乐性展览;企业形象策划;市场营销策划;摄像及视频制作服务;影视美术道具置景服务;摄影扩印服务;电影摄制服务;婚庆礼仪服务;礼仪服务;文艺创作;文化娱乐经纪人服务;体育经纪人服务;其他文化艺术经纪代理;信息咨询服务（不含许可类信息咨询服务）;市场调查（不含涉外调查）;采购代理服务;档案整理服务;招投标代理服务;供应链管理服务;政府采购代理服务;平面设计;工业设计服务;专业设计服务;广告设计、代理;广告制作;广告发布（非广播电台、电视台、报刊出版单位）;打字复印;图文设计制作;3D打印服务;包装服务;品牌管理;餐饮管理;企业管理;物业管理;规划设计管理;对外承包工程;园林绿化工程施工;知识产权服务;创业空间服务;居民日常生活服务;劳务服务（不含劳务派遣）;人力资源服务（不含职业中介活动、劳务派遣服务）;教育咨询服务（不含涉许可审批的教育培训活动）;软件开发;动漫游戏开发;技术服务、技术开发、技术咨询、技术交流、技术转让、技术推广;区块链技术相关软件和服务;数字文化创意内容应用服务;物联网技术服务;物联网应用服务;服装服饰零售;服装服饰出租;礼品花卉销售;花卉绿植租借与代管理;户外用品销售;日用百货销售;办公设备耗材销售;金属制品销售;办公用品销售;办公设备销售;办公设备租赁服务;体育用品设备出租;文化用品设备出租;休闲娱乐用品设备出租;互联网销售（除销售需要许可的商品）;以自有资金从事投资活动;食品经营（销售预包装食品）;食品互联网销售（销售预包装食品）
广州涵萱文化传播有限公司	舞台表演艺术指导服务;艺术表演场馆管理服务;舞台安装、搭建服务;舞台灯光、音响设备安装服务;群众参与的文艺类演出、比赛等公益性文化活动的策划;文化传播（不含许可经营项目）;文化推广（不含许可经营项目）;互联网商品销售（许可审批类商品除外）;互联网商品零售（许可审批类商品除外）;商品批发贸易（许可审批类商品除外）;商品零售贸易（许可审批类商品除外）;市场营销策划服务;文化娱乐经纪人;影视经纪代理服务;音像经纪代理服务;文学、艺（美）术经纪代理服务;大型活动组织策划服务（大型活动指晚会、运动会、庆典、艺术和模特大赛、艺术节、电影节及公益演出、展览等，需专项审批的活动应在取得审批后方可经营）;网络信息技术推广服务;网络技术的研究、开发;企业形象策划服务;软件技术推广服务;专业网络平台的构建和运营（法律、行政法规、国务院决定禁止的项目除外，依法须取得许可的项目，须取得许可后方可经营）;电影和影视节目制作;音像制品制作;付费广播节目播出服务;国内广播节目播出服务;广播电视节目制作（具体经营范围以《广播电视节目制作经营许可证》为准）;信息网络传播视听节目业务;网络游戏服务;网络音乐服务;演出经纪代理服务;网上图片服务;网上视频服务;预包装食品批发;网络销售预包装食品;保健食品批发（具体经营项目以《食品经营许可证》为准）;保健食品零售（具体经营项目以《食品经营许可证》为准）;预包装食品零售
广东中勘华恒文化服务有限公司	基础地质勘查;地质勘查技术服务;工程技术服务（规划管理、勘察、设计、监理除外）;对外承包工程;劳务服务（不含劳务派遣）;人力资源服务（不含职业中介活动、劳务派遣服务）;艺（美）术品、收藏品鉴定评估服务;非物质文化遗产保护;文物文化遗址保护服务;文艺创作;规划设计管理;建筑工程机械与设备租赁;建筑物清洁服务;咨询策划服务;工程管理服务;图文设计制作;海洋工程设计和模块设计制造服务;会议及展览服务;技术服务、技术开发、技术咨询、技术交流、技术转让、技术推广;建筑劳务分包;文物保护工程施工;建设工程施工;各类工程建设活动;工程造价咨询业务;建设工程监理;建设工程设计;文物保护工程设计;检验检测服务;文物保护工程勘察;建设工程勘察
英皇娱艺影院（广东）有限公司	票务代理服务;日用百货销售;日用品销售;非居住房地产租赁;广告发布（非广播电台、电视台、报刊出版单位）;广告设计、代理;广告制作;物业管理;社会经济咨询服务;电影放映;食品经营（销售预包装食品）;食品经营;小餐饮、小食杂、食品小作坊经营
保利商业地产投资管理有限公司	体验式拓展活动及策划;企业形象策划;市场营销策划;企业管理咨询;图文设计制作;体育赛事策划;广告发布（非广播电台、电视台、报刊出版单位）;酒店管理;会议及展览服务;非居住房地产租赁;物业管理;组织文化艺术交流活动;日用百货销售;未经加工的坚果、干果销售;新鲜蔬菜零售;鲜肉零售;鲜蛋零售;鲜蛋批发;水产品零售;针纺织品销售;日用杂品销售;服装服饰零售;五金产品零售;玩具销售;美发饰品销售;礼品花卉销售;文具用品零售;文具用品批发;体育用品及器材零售;珠宝首饰零售;珠宝首饰批发;家用视听设备销售;宠物食品及用品批发;日用家电零售;新鲜水果零售;鞋帽零售;停车场服务;粮油仓储服务;豆及薯类销售;图书出租;化妆品批发;化妆品零售;个人卫生用品销售;数字视频监控系统销售;办公设备租赁服务;仓储设备租赁服务;工艺美术品及收藏品批发（象牙及其制品除外）;工艺美术品及收藏品零售（象牙及其制品除外）;体育竞赛组织;体育保障组织;体育中介代理服务;体育健康服务;组织体育表演活动;体育经纪人服务;业务培训（不含教育培训、职业技能培训等需取得许可的培训）;招生辅助服务;文化场馆管理服务;摄像及视频制作服务;教育教学检测和评价活动;健身休闲活动;体育场地设施工程施工;体育用品设备出租;艺术品代理;互联网销售（除销售需要许可的商品）;数字内容制作服务（不含出版发行）;文艺创作;园林绿化工程施工;平面设计;创业空间服务;专业设计服务;房地产开发经营;城市配送运输服务（不含危险货物）;酒类经营;食品经营（销售散装食品）;烟草制品零售;电影放映;餐饮服务;现制现售饮用水;体育场地设施经营（不含高危险性体育运动）;文物拍卖;出版物零售;住宅室内装饰装修
利淮国际文化产业有限公司	旅游开发项目策划咨询;停车场服务;房地产咨询;房地产评估;房地产经纪;酒店管理;销售代理;社会经济咨询服务;物业管理;园林绿化工程施工;工程管理服务;旅行社服务网点旅游招徕、咨询服务;住房租赁;非居住房地产租赁;普通机械设备安装服务;建筑物清洁服务;家具安装和维修服务;家用电器安装服务;公共事业管理服务;居民日常生活服务;招投标代理服务;票务代理服务;旅客票务代理;住宅水电安装维护服务;专业设计服务;文艺创作;数字文化创意内容应用服务;数字内容制作服务（不含出版发行）;休闲观光活动;组织文化艺术交流活动;组织体育表演活动;体育中介代理服务;其他文化艺术经纪代理;影视美术道具置景服务;广播影视设备销售;游览景区管理;园区管理服务;办公服务;文化娱乐经纪人服务;公园、景区小型设施娱乐活动;文化用品设备出租;信息安全设备销售;物业服务评估;文化场馆管理服务;工程技术服务（规划管理、勘察、设计、监理除外）;企业总部管理;单位后勤管理服务;餐饮管理;商业综合体管理服务;会议及展览服务;专业保洁、清洗、消毒服务;家政服务;环保咨询服务;安防设备销售;人工智能行业应用系统集成服务;软件开发;建筑装饰材料销售;日用百货销售;金属门窗工程施工;代驾服务;技术服务、技术开发、技术咨询、技术交流、技术转让、技术推广;互联网数据服务;普通货物仓储服务（不含危险化学品等需许可审批的项目）;档案整理服务;科技中介服务;以自有资金从事投资活动;人力资源服务（不含职业中介活动、劳务派遣服务）;市场营销策划;咨询策划服务;护理机构服务（不含医疗服务）;广告设计、代理;广告制作;铁路运输辅助活动;商务代理代办服务;集贸市场管理服务;城市绿化管理;市政设施管理;环境卫生公共设施安装服务;洗车服务;餐饮器具集中消毒服务;城市公园管理;体育用品及器材批发;健身休闲活动;电子、机械设备维护（不含特种设备）;计算机及办公设备维修;信息技术咨询服务;人工智能应用软件开发;信息咨询服务（不含许可类信息咨询服务）;业务培训（不含教育培训、职业技能培训等需取得许可的培训）;病人陪护服务;食品经营（仅销售预包装食品）;企业管理咨询;水污染治理;环境保护专用设备销售;病媒生物防治服务;机械设备租赁;特种设备销售;婚庆礼仪服务;体育保障组织;仓储设备租赁服务;特种设备出租;家具销售;信息系统集成服务;计算机软硬件及辅助设备零售;软件销售;棋牌室服务;船舶租赁;服装服饰批发;服装辅料销售;箱包销售;日用品销售;文具用品批发;文具用品零售;玩具销售;体育用品及器材零售;化妆品批发;化妆品零售;个人卫生用品销售;鞋帽批发;鞋帽零售;厨具卫具及日用杂品批发;智能家庭消费设备销售;室内空气污染治理;创业空间服务;养老服务;电影摄制服务;旅游业务;消防技术服务;广告发布（广播电台、电视台、报刊出版单位）;货物进出口;工程造价咨询业务;施工专业作业;特种设备安装改造修理;城市生活垃圾经营性服务;道路货物运输（不含危险货物）;公路管理与养护;餐饮服务;高危险性体育运动（游泳）;体育场地设施经营（不含高危险性体育运动）;足浴服务;美容服务;建设工程施工;室内环境检测;建设工程设计;住宅室内装饰装修;电气安装服务;住宿服务;营业性演出;网络文化经营;互联网信息服务;电子出版物制作;演出场所经营;广播电视节目制作经营
壹动漫（广州）文化传媒有限公司	动漫及衍生产品设计服务;广告业;箱、包批发;玩具批发;玩具零售;商品批发贸易（许可审批类商品除外）;数字动漫制作;游戏软件设计制作;技术进出口;电子产品零售;投资咨询服务;美术图案设计服务;商品零售贸易（许可审批类商品除外）;文化艺术咨询服务;电子产品设计服务;群众参与的文艺类演出、比赛等公益性文化活动的策划;大型活动组织策划服务（大型活动指晚会、运动会、庆典、艺术和模特大赛、艺术节、电影节及公益演出、展览等,需专项审批的活动应在取得审批后方可经营）;文化推广（不含许可经营项目）;文化传播（不含许可经营项目）;文艺创作服务;艺（美）术创作服务;文化娱乐经纪人;展台设计服务;其他文化娱乐用品批发;动漫（动画）经纪代理服务;玩具设计服务;企业自有资金投资;家居饰品批发;信息技术咨询服务;货物进出口（专营专控商品除外）;文化研究;服装批发;文具用品批发;服装零售;贸易咨询服务;企业管理咨询服务;多媒体设计服务;模型设计服务;报刊批发;网上电影服务;电影放映;网络游戏服务;图书批发;网上动漫服务;音像制品及电子出版物批发;音像制品制作
广东天石控股集团有限公司	艺术表演场馆管理服务;企业自有资金投资;投资咨询服务;场地租赁（不含仓储）;物业管理;舞台灯光、音响设备安装服务;楼宇设备自控系统工程服务;智能化安装工程服务;音频和视频设备租赁;房屋建筑工程施工;广告业;影视经纪代理服务;房地产开发经营;演出经纪代理服务
广东咏声动漫股份有限公司	广告业;货物进出口（专营专控商品除外）;技术进出口;软件零售;文具用品零售;工艺美术品零售（象牙及其制品除外）;服装零售;鞋零售;帽零售;玩具零售;软件服务;房屋租赁;软件开发;数字动漫制作;信息技术咨询服务;动漫及衍生产品设计服务;电影和影视节目发行;电影和影视节目制作;演出经纪代理服务;营业性文艺表演;网上动漫服务
广州骑乐马文化产业发展有限公司	技术服务、技术开发、技术咨询、技术交流、技术转让、技术推广;文化娱乐经纪人服务;其他文化艺术经纪代理;组织文化艺术交流活动;租借道具活动;咨询策划服务;体验式拓展活动及策划;项目策划与公关服务;企业形象策划;面向家长实施的家庭教育咨询服务;企业管理咨询;企业管理;信息技术咨询服务;市场营销策划;体育经纪人服务;组织体育表演活动;体育健康服务;体育中介代理服务;体育保障组织;体育竞赛组织;体育赛事策划;体育用品设备出租;体育用品及器材零售;体育用品及器材批发;体育场地设施工程施工;科技中介服务;牲畜饲养;营业性演出;体育场地设施经营（不含高危险性体育运动）
广州中远海运文化传播有限公司	组织文化艺术交流活动;票务代理服务;旅客票务代理;日用品销售;文艺创作;会议及展览服务;广告制作;广告发布（非广播电台、电视台、报刊出版单位）;广告设计、代理;商务代理代办服务;从事语言能力、艺术、体育、科技等培训的营利性民办培训服务机构（除面向中小学生开展的学科类、语言类文化教育培训）;健身休闲活动;住宿服务;餐饮服务;酒类经营;食品经营（销售预包装食品）
广州力天文化创意产业集团有限公司	室内装饰、装修;室内装饰设计服务;工程总承包服务;会议及展览服务;策划创意服务;多媒体设计服务;计算机技术开发、技术服务;软件开发;软件服务;软件批发;数字动漫制作;信息系统集成服务;智能化安装工程服务;计算机零售;计算机零配件零售;计算机批发;计算机零配件批发;安全技术防范产品批发;安全技术防范产品零售;通信技术研究开发、技术服务;信息电子技术服务;电子产品零售;电子产品批发;机电设备安装服务;消防设施工程专业承包;消防设施工程设计与施工;消防设备、器材的批发;消防设备、器材的零售;商品批发贸易（许可审批类商品除外）;软件零售;文艺创作服务;艺（美）术创作服务
广东华翰文化集团有限公司	非物质文化遗产保护;文艺创作;组织文化艺术交流活动;档案整理服务;打字复印;动漫游戏开发;教育咨询服务（不含涉许可审批的教育培训活动）;市场营销策划;企业形象策划;咨询策划服务;企业管理咨询;企业信用修复服务;版权代理;国内贸易代理;互联网销售（除销售需要许可的商品）;广告设计、代理;广告制作;广告发布（非广播电台、电视台、报刊出版单位）;企业信用管理咨询服务;企业信用评级服务;创业投资（限投资未上市企业）;以自有资金从事投资活动;出版物批发;出版物零售
广州中山大学出版社有限公司	企业形象策划服务;美术图案设计服务;公司礼仪服务;投资咨询服务;会议及展览服务;广告业;企业管理咨询服务;商品信息咨询服务;软件开发;信息技术咨询服务;数据处理和存储服务;数字动漫制作;互联网出版业;图书出版;图书批发;图书、报刊零售
广州曦望文化传播股份有限公司	策划创意服务;软件服务;公司礼仪服务;模特服务;个人形象设计服务;企业形象策划服务;会议及展览服务;多媒体设计服务;软件开发;广告业;计算机技术开发、技术服务;市场营销策划服务;文艺创作服务;文化艺术咨询服务;大型活动组织策划服务（大型活动指晚会、运动会、庆典、艺术和模特大赛、艺术节、电影节及公益演出、展览等，需专项审批的活动应在取得审批后方可经营）;房地产中介服务;房地产咨询服务;货物进出口（专营专控商品除外）;技术进出口;商品批发贸易（许可审批类商品除外）;商品零售贸易（许可审批类商品除外）;贸易咨询服务;预包装食品零售
珠江电影制片有限公司	广东省内电影的流动放映;广东省电影放映经营,收集、整理、储存和发布影视专业技术人才供求信息;影视专业技术人才经纪、招聘、培训、资源开发与管理咨询;经营演出及经纪业务;转售水电业务及水电安装维修;停车场经营;自有影视作品版权贸易;国内贸易。以下项目由分支机构经营:物业管理,旅业。（依法须经批准的项目,经相关部门批准后方可开展经营活动）
一些事一些情广东集团有限公司	国内广播节目播出服务;文化推广（不含许可经营项目）;文化传播（不含许可经营项目）;文化艺术咨询服务;文化研究;广告业;大型活动组织策划服务（大型活动指晚会、运动会、庆典、艺术和模特大赛、艺术节、电影节及公益演出、展览等,需专项审批的活动应在取得审批后方可经营）;模特服务;公司礼仪服务;策划创意服务;企业形象策划服务;软件开发;数据处理和存储服务;网络技术的研究、开发;互联网商品销售（许可审批类商品除外）;互联网商品零售（许可审批类商品除外）;商品批发贸易（许可审批类商品除外）;商品零售贸易（许可审批类商品除外）;商品信息咨询服务;贸易咨询服务;贸易代理;皮革及皮革制品批发;箱、包批发;箱、包零售;宝石饰品批发;宝石饰品零售;货物进出口（专营专控商品除外）;技术进出口;房地产开发经营;房地产中介服务;房地产咨询服务;园林绿化工程服务;建筑工程后期装饰、装修和清理;土石方工程服务;架线工程服务;照明系统安装;建筑物自来水系统安装服务;室内装饰、装修;物业管理;租赁业务;房屋租赁;场地租赁（不含仓储）;市场营销策划服务;市场调研服务;投资咨询服务;企业管理服务（涉及许可经营项目的除外）;企业管理咨询服务;酒店管理;餐饮管理;教育咨询服务;税务师事务所业务;企业财务咨询服务;工商咨询服务;工商登记代理服务;健康科学项目研究、开发;健康管理咨询服务（须经审批的诊疗活动、心理咨询除外,不含许可经营项目,法律法规禁止经营的项目不得经营）;营养健康咨询服务;体育营销策划服务;健身服务;林业科学研究服务;造林、育林;内陆养殖;农业科学研究和试验发展;农业项目开发
广州金润文化传播有限公司	文艺创作服务;群众参与的文艺类演出、比赛等公益性文化活动的策划;会议及展览服务;市场调研服务;投资咨询服务;商品信息咨询服务;广告业;包装装潢设计服务;饰物装饰设计服务;展台设计服务;美术图案设计服务;网络技术的研究、开发;计算机技术开发、技术服务;商品批发贸易（许可审批类商品除外）;商品零售贸易（许可审批类商品除外）;货物进出口（专营专控商品除外）;技术进出口;企业管理咨询服务;企业管理服务（涉及许可经营项目的除外）;室内装饰、设计;电影和影视节目制作;电影和影视节目发行
广东立本文化传媒有限公司	广告发布（非广播电台、电视台、报刊出版单位）;广告制作;广告设计、代理;图文设计制作;平面设计;专业设计服务;网络技术服务;项目策划与公关服务;体育用品及器材零售;新鲜水果零售;服装服饰批发;食品销售（仅销售预包装食品）;食品互联网销售（仅销售预包装食品）;谷物销售;露营地服务;动漫游戏开发;数字文化创意软件开发;数字文化创意内容应用服务;旅游开发项目策划咨询;体验式拓展活动及策划;咨询策划服务;企业管理咨询;市场营销策划;企业形象策划;体育赛事策划;文艺创作;组织文化艺术交流活动;文化场馆管理服务;标准化服务;摄像及视频制作服务;影视美术道具置景服务;摄影扩印服务;礼仪服务;品牌管理;社会调查（不含涉外调查）;信息咨询服务（不含许可类信息咨询服务）;市场调查（不含涉外调查）;企业管理;文化用品设备出租;体育用品设备出租;业务培训（不含教育培训、职业技能培训等需取得许可的培训）;招生辅助服务;娱乐性展览;租借道具活动;其他文化艺术经纪代理;体育经纪人服务;文化娱乐经纪人服务;组织体育表演活动;休闲观光活动;体育健康服务;体育中介代理服务;健身休闲活动;体育竞赛组织;广播电视节目制作经营;广告发布（广播电台、电视台、报刊出版单位）;食品经营;食品销售;信息网络传播视听节目;网络文化经营;歌舞娱乐活动;演出经纪;体育场地设施经营（不含高危险性体育运动）;演出场所经营;营业性演出
广州集特尚文化创意有限公司	工业设计服务;动漫及衍生产品设计服务;广告业;玩具批发;电子元器件批发;商品批发贸易（许可审批类商品除外）;策划创意服务;陶瓷、玻璃器皿批发;饰物装饰设计服务;玻璃钢制品批发;互联网商品销售（许可审批类商品除外）;艺（美）术装裱、封装服务;室内装饰设计服务;保安器材销售;标识、标志牌设计、安装服务;美术图案设计服务;美术品批发;电工金具的销售;珠宝首饰设计服务;商品零售贸易（许可审批类商品除外）;风景园林工程设计服务;文化艺术咨询服务;电子产品设计服务;城市规划设计;纺织品及针织品零售;鞋批发;鞋设计;办公设备耗材批发;摄影服务;日用器皿及日用杂货批发;家具设计服务;电子产品批发;市场营销策划服务;彩灯、花灯设计服务;艺（美）术创作服务;会议及展览服务;展台设计服务;摄影艺术辅导服务;服装辅料批发;玩具设计服务;建材、装饰材料批发;纺织品、针织品及原料批发;工艺品批发;包装材料的销售;灯饰设计服务;信息技术咨询服务;包装服务;时装设计服务;包装装潢设计服务;服装批发;化妆品及卫生用品批发;家用电器批发;文具用品批发;企业管理咨询服务;企业形象策划服务;多媒体设计服务;模型设计服务;市场调研服务;商品信息咨询服务;房屋建筑工程设计服务;货物进出口（专营专控商品除外）;技术进出口;预包装食品批发;预包装食品零售
广州格乐丽雅文化产业有限公司	日用百货销售;摄像及视频制作服务;广告设计、代理;企业形象策划;广告制作;信息咨询服务（不含许可类信息咨询服务）;广告发布（非广播电台、电视台、报刊出版单位）;服装服饰零售;其他文化艺术经纪代理;服装服饰批发;工艺美术品及礼仪用品制造（象牙及其制品除外）;化妆品批发;技术服务、技术开发、技术咨询、技术交流、技术转让、技术推广;会议及展览服务;婚庆礼仪服务;办公设备租赁服务;化妆品零售;餐饮管理;食品经营（销售预包装食品）;餐饮服务;食品互联网销售（销售预包装食品）
广东奇域恒清文化发展有限公司	文艺创作服务;群众参与的文艺类演出、比赛等公益性文化活动的策划;广告业;办公服务;公共关系服务;市场调研服务;市场营销策划服务;企业形象策划服务;策划创意服务;大型活动组织策划服务（大型活动指晚会、运动会、庆典、艺术和模特大赛、艺术节、电影节及公益演出、展览等，需专项审批的活动应在取得审批后方可经营）;会议及展览服务;文化艺术咨询服务;公司礼仪服务;文化娱乐经纪人;美术展览经纪代理服务;企业管理咨询服务;企业自有资金投资;舞台表演艺术指导服务;影视经纪代理服务;投资咨询服务;教育咨询服务;商品批发贸易（许可审批类商品除外）;商品零售贸易（许可审批类商品除外）;软件服务;包装服务;模特服务;个人形象设计服务;票务服务;货物进出口（专营专控商品除外）;技术进出口;版权服务;体育赛事运营（涉及许可项目的，需取得许可后方可经营）;音频和视频设备租赁;视频设备出租服务;体育运动咨询服务;商品信息咨询服务;国学教育咨询服务;体育营销策划服务;灯光设备租赁;图书出租;音像制品出租;音像经纪代理服务;动漫及衍生产品设计服务;娱乐设备出租服务
广东大爱志愿者文化传播有限公司	技术服务、技术开发、技术咨询、技术交流、技术转让、技术推广;企业管理咨询;信息咨询服务（不含许可类信息咨询服务）;咨询策划服务;其他文化艺术经纪代理;艺术品代理;国内贸易代理;贸易经纪;计算机系统服务;票务代理服务;第二类医疗器械销售;劳动保护用品销售;专业保洁、清洗、消毒服务;消毒剂销售（不含危险化学品）;商务代理代办服务;机械零件、零部件销售;电子产品销售;货物进出口;技术进出口;进出口代理;互联网新闻信息服务;电视剧发行;信息网络传播视听节目;网络文化经营;出版物零售;第二类医疗器械生产
广州百漫文化传播有限公司	电影摄制服务;数字内容制作服务（不含出版发行）;文艺创作;专业设计服务;广告制作;平面设计;广告发布（非广播电台、电视台、报刊出版单位）;广告设计、代理;玩具销售;玩具、动漫及游艺用品销售;玩具制造;软件开发;区块链技术相关软件和服务;动漫游戏开发;互联网数据服务;文具用品批发;文具用品零售;数字文化创意软件开发;文具制造;电视剧发行;电影发行;音像制品制作;电视剧制作;电子出版物制作;广播电视节目制作经营;互联网信息服务;信息网络传播视听节目;网络文化经营;出版物零售;电子出版物复制;出版物互联网销售
广州杰森动漫文化有限公司	食品销售（仅销售预包装食品）;文艺创作;软件开发;动漫游戏开发;玩具、动漫及游艺用品销售;信息技术咨询服务;电子产品销售;广告设计、代理;图文设计制作;专业设计服务;平面设计;企业形象策划;工艺美术品及礼仪用品制造（象牙及其制品除外）;工艺美术品及收藏品零售（象牙及其制品除外）;工艺美术品及收藏品批发（象牙及其制品除外）;国内贸易代理;服装服饰批发;服装服饰零售;服装辅料销售;纸制品销售;玩具销售;日用陶瓷制品制造;新型陶瓷材料销售;卫生陶瓷制品销售;箱包销售;计算机系统服务
广东胜效传媒股份有限公司	广告业;路牌、路标、广告牌安装施工;商务文印服务;音像经纪代理服务;影视经纪代理服务;策划创意服务;市场调研服务;市场营销策划服务;企业形象策划服务;软件服务;包装服务;劳务承揽;电影和影视节目制作;电影放映;音像制品制作;录音制作;音像制品出版;营业性文艺表演;本册印制;包装装潢印刷品印刷;电子出版物出版
广东好天使文化发展企业（有限合伙）	文艺创作服务;企业自有资金投资;企业管理服务（涉及许可经营项目的除外）;资产管理（不含许可审批项目）;投资管理服务;供应链管理;机械设备租赁;技术进出口;货物进出口（专营专控商品除外）;商品批发贸易（许可审批类商品除外）
广东砖头创客文化传媒有限公司	群众参与的文艺类演出、比赛等公益性文化活动的策划;策划创意服务;市场营销策划服务;大型活动组织策划服务（大型活动指晚会、运动会、庆典、艺术和模特大赛、艺术节、电影节及公益演出、展览等,需专项审批的活动应在取得审批后方可经营）;会议及展览服务;网络技术的研究、开发;计算机技术开发、技术服务;计算机零配件批发;计算机零配件零售;信息技术咨询服务;信息电子技术服务;商品信息咨询服务;企业管理咨询服务;企业形象策划服务;公司礼仪服务;公共关系服务;广告业
广州香蔓蕾文化发展有限公司	舞台表演化妆服务;商品批发贸易（许可审批类商品除外）;商品零售贸易（许可审批类商品除外）;商品信息咨询服务;公司礼仪服务;贸易代理;佣金代理;会议及展览服务;互联网商品销售（许可审批类商品除外）;互联网商品零售（许可审批类商品除外）;文艺创作服务;美术展览经纪代理服务;货物进出口（专营专控商品除外）;网络技术的研究、开发;计算机技术开发、技术服务;大型活动组织策划服务（大型活动指晚会、运动会、庆典、艺术和模特大赛、艺术节、电影节及公益演出、展览等，需专项审批的活动应在取得审批后方可经营）;计算机网络系统工程服务;广告业;影视经纪代理服务;企业管理服务（涉及许可经营项目的除外）;企业形象策划服务;化妆品零售;个人形象设计服务;化妆品及卫生用品批发;化妆品批发;化妆品及卫生用品零售;进出口商品检验鉴定（具体经营项目以《进出口商品检验鉴定机构资格证书》载明为准）
广东万华文化传播有限公司	五金产品零售;五金产品批发;玻璃纤维及制品销售;玻璃纤维及制品制造;照明器具销售;照明器具制造;人造板销售;文化用品设备出租;文艺创作;塑料制品销售;办公服务;食品经营（仅销售预包装食品）;五金产品制造;人力资源服务（不含职业中介活动、劳务派遣服务）;企业管理咨询;体验式拓展活动及策划;工艺美术品及收藏品零售（象牙及其制品除外）;教育教学检测和评价活动;业务培训（不含教育培训、职业技能培训等需取得许可的培训）;体育用品设备出租;对外承包工程;喷涂加工;激光打标加工;金属门窗工程施工;日用木制品制造;交通及公共管理用金属标牌制造;塑料制品制造;纸制品制造;人造板制造;包装材料及制品销售;金属结构制造;体育消费用智能设备制造;可穿戴智能设备制造;文化场馆用智能设备制造;体育用品制造;职工疗休养策划服务;影视美术道具置景服务;咨询策划服务;摄像及视频制作服务;婚庆礼仪服务;摄影扩印服务;3D打印服务;平面设计;广告设计、代理;健康咨询服务（不含诊疗服务）;市场营销策划;信息咨询服务（不含许可类信息咨询服务）;市场调查（不含涉外调查）;企业管理;礼仪服务;商务秘书服务;品牌管理;广告制作;广告发布（非广播电台、电视台、报刊出版单位）;项目策划与公关服务;商务代理代办服务;图文设计制作;包装服务;会议及展览服务;票据信息咨询服务;企业形象策划;供应链管理服务;采购代理服务;体育赛事策划;商业综合体管理服务;信息系统运行维护服务;信息技术咨询服务;人工智能应用软件开发;软件开发;网络技术服务;数字内容制作服务（不含出版发行）;数据处理和存储支持服务;人工智能公共数据平台;大数据服务;物联网应用服务;区块链技术相关软件和服务;数字文化创意内容应用服务;远程健康管理服务;电子产品销售;办公用品销售;办公设备耗材销售;软件销售;鞋帽批发;服装服饰批发;互联网销售（除销售需要许可的商品）;户外用品销售;箱包销售;礼品花卉销售;日用品销售;家居用品销售;体育用品及器材批发;玩具、动漫及游艺用品销售;租借道具活动;组织文化艺术交流活动;体育经纪人服务;文化娱乐经纪人服务;组织体育表演活动;体育竞赛组织;体育健康服务;体育中介代理服务;健身休闲活动;电影摄制服务;个人互联网直播服务（需备案）;包装装潢印刷品印刷;出版物印刷;建设工程施工;食品互联网销售;食品经营（销售散装食品）;保健食品销售;食品互联网销售（销售预包装食品）;食品销售;各类工程建设活动;施工专业作业;印刷品装订服务;电子出版物复制;建设工程设计;工程造价咨询业务;广告发布（广播电
广东五千年传统文化有限公司	文化交流活动的策划,电脑动画设计,计算机技术开发、技术转让及技术咨询,图文设计与制作,会议及展览服务,艺术摄影,园林艺术设计;销售:工艺品、服装、鞋帽、箱包、家用电器、通讯及广播电视设备（不含卫星电视广播地面接收设备）,第一类医疗器械产品及实行备案的品种;设计、制作、代理和发布国内外各类广告;汽车租赁（不带驾驶人员）;货物进出口、技术进出口（法律、行政法规禁止的项目除外;法律、行政法规限制的项目须取得许可后方可经营）。
广州市亚洲吃面文化发展有限公司	文艺创作服务;厨房用具及日用杂品零售;冷冻肉零售;场地租赁（不含仓储）;广告业;企业形象策划服务;企业管理咨询服务;投资咨询服务;教育咨询服务;室内装饰设计服务;饰物装饰设计服务;美术图案设计服务;玩具设计服务;模型设计服务;灯光设备租赁;自有设备租赁（不含许可审批项目）;餐饮管理;标识、标志牌设计、安装服务;展台设计服务;商品零售贸易（许可审批类商品除外）;市场营销策划服务;陶瓷、玻璃器皿零售;灯饰设计服务;会议及展览服务;策划创意服务;企业管理服务（涉及许可经营项目的除外）;熟食零售;调味品零售;预包装食品零售;食品经营管理
莱德队长（广州）文化体育发展有限公司	体育器材装备安装服务;体育组织;体育用品及器材批发;体育用品及器材零售;体育运动咨询服务;体育营销策划服务;体育项目投资与管理;体育赛事运营（涉及许可项目的,需取得许可后方可经营）;广告业;服装批发;服装零售;体育设备、器材出租;策划创意服务;群众参与的文艺类演出、比赛等公益性文化活动的策划;商品批发贸易（许可审批类商品除外）;商品零售贸易（许可审批类商品除外）;竞技体育科技服务;运动场馆服务（游泳馆除外）;广播电视节目制作（具体经营范围以《广播电视节目制作经营许可证》为准）;赛事转播服务
